1c1d1e1f
10 15
587 617 428 429 581 545 583 622 560 230 231 782 912 913 914
524 522 460 551 579 616 779 558 687 131 163 131 944 945 946
525 424 492 582 160 780 64 64 131 674 163 784 785 131 720
559 746 494 592 230 145 273 199 198 199 131 162 162 163 70
652 744 745 66 720 270 231 230 433 176 131 672 197 782 102
140 15 98 782 70 238 163 162 270 231 163 131 674 741 773
6 38 71 70 143 98 99 198 231 131 131 782 131 782 228
102 111 38 6 6 71 388 301 720 130 749 750 720 163 783
816 817 102 114 38 103 206 131 162 131 559 714 650 745 815
848 849 782 76 103 198 435 209 131 784 785 749 750 652 653
