1c1d331f
18 18
653 684 99 198 263 203 685 633 685 142 103 782 720 782 132 230 401 401
261 202 262 805 144 201 269 633 100 46 783 782 132 684 206 132 300 294
238 298 304 306 295 304 232 2 209 720 132 816 132 208 176 266 804 132
681 688 44 79 71 266 357 696 132 816 817 132 849 198 176 356 235 132
577 712 688 102 143 234 695 635 597 132 849 132 132 300 294 337 261 132
386 613 385 688 46 596 598 720 599 539 538 603 538 571 630 132 396 132
494 779 747 719 631 629 775 776 777 132 720 600 782 132 599 538 34 570
571 538 539 571 598 749 750 64 685 782 817 2 100 782 784 785 366 367
749 750 591 577 712 558 64 782 684 653 132 600 720 816 817 720 361 132
424 613 419 386 560 782 132 783 684 782 685 601 783 848 849 132 132 70
491 614 616 560 687 132 684 815 132 132 720 600 815 782 903 904 905 142
523 453 780 652 685 70 71 720 816 817 132 2 395 132 935 936 937 102
559 589 652 653 44 114 143 100 848 849 132 696 230 199 967 968 969 132
652 653 685 132 132 932 102 79 71 784 785 604 597 292 337 231 332 337
80 851 852 853 132 132 932 47 111 45 596 629 599 630 132 132 132 132
107 883 884 885 132 132 631 538 571 570 598 836 900 628 597 132 7 132
71 915 916 917 132 932 37 69 132 132 268 391 301 804 599 539 39 538
73 134 82 79 45 132 600 132 132 198 295 294 263 203 132 132 11 132
