1c1d1e1f
12 18
587 617 428 429 583 545 583 622 560 685 23 476 477 478 124 807 808 809
524 522 460 428 613 425 779 558 687 131 66 27 509 510 22 839 840 841
525 424 492 465 559 589 652 653 131 804 804 131 21 24 131 871 872 873
559 746 494 592 684 685 131 131 198 434 199 131 100 98 720 130 331 162
685 782 720 66 720 67 836 162 270 433 401 390 133 131 932 162 771 676
140 15 98 99 100 228 771 672 270 231 238 720 131 782 131 131 131 198
113 103 810 811 812 98 99 198 231 720 131 743 131 196 673 131 208 433
102 45 842 843 844 162 388 301 720 130 655 622 650 677 100 202 267 360
100 720 298 328 272 267 206 676 197 131 751 647 677 134 71 302 303 720
135 141 130 298 301 198 435 209 674 775 776 675 76 38 103 234 325 203
6 81 932 98 720 230 231 782 655 651 745 704 131 46 131 131 264 303
38 6 71 112 71 162 720 591 513 465 675 131 70 73 131 131 270 201
