1c1d661f
17 21
722 754 723 721 784 785 720 131 720 816 817 782 685 462 616 496 685 784 785 131 131
754 722 722 818 782 131 782 720 783 848 849 685 723 495 544 465 685 783 131 720 782
722 755 753 64 66 782 67 66 815 782 99 721 755 495 424 560 685 815 782 720 131
818 721 64 131 131 99 720 720 99 99 685 685 679 559 589 652 653 868 868 783 720
64 64 131 720 131 70 82 71 99 685 685 557 648 818 684 685 131 142 169 815 782
131 950 951 952 1014 142 868 143 684 653 557 618 682 721 685 131 44 38 137 720 783
782 982 983 984 1015 102 167 173 685 655 459 464 818 685 99 131 720 102 6 45 815
131 64 131 64 131 131 684 685 626 459 618 560 652 70 71 131 131 782 46 782 816
131 70 71 162 131 684 653 786 723 748 560 652 685 142 143 131 131 131 131 816 814
720 142 143 14 684 685 721 755 755 755 687 67 131 102 80 782 131 720 131 944 945
131 102 38 38 71 685 652 653 721 64 131 67 720 131 107 782 70 135 141 784 785
131 782 142 6 6 71 932 131 64 131 100 720 782 131 720 131 102 38 6 45 783
131 131 102 38 38 103 932 131 131 816 131 131 131 131 720 131 131 142 103 720 815
783 782 720 102 103 131 131 782 131 848 131 131 131 720 131 131 720 953 954 955 131
815 131 783 131 782 131 131 131 131 131 131 785 131 131 131 131 131 985 986 987 720
783 131 880 785 131 131 131 816 817 131 131 131 131 131 131 131 131 131 720 131 782
848 881 946 131 782 131 784 815 131 131 785 720 720 131 880 881 882 720 720 784 785
