1c1d1e1f
30 28
163 868 672 197 67 67 102 114 6 6 103 720 628 630 67 675 102 6 38 6 6 71 228 672 677 721 67 720
868 70 71 674 956 957 958 67 142 80 196 801 70 2 67 67 67 102 111 111 111 114 71 721 723 721 782 70
70 6 103 67 988 989 990 67 102 103 100 44 103 628 538 570 597 741 673 676 772 66 46 950 951 952 1014 102
6 81 163 67 64 67 64 162 67 742 743 742 67 67 67 743 599 630 44 15 737 675 67 982 983 984 1015 720
102 38 82 79 75 67 67 742 591 579 425 581 577 497 655 459 497 628 630 46 67 67 720 64 100 64 782 76
70 6 6 38 109 67 655 623 583 609 455 492 583 545 581 616 560 67 2 67 686 782 70 82 71 784 785 108
38 6 38 103 679 655 425 833 577 618 583 545 586 387 461 560 65 67 600 626 426 593 142 6 868 782 67 782
38 38 103 66 742 430 459 429 583 717 779 747 560 781 560 720 67 631 629 655 616 593 142 6 38 45 67 783
102 143 67 626 714 867 616 553 545 560 956 957 958 64 64 67 67 600 626 545 496 67 102 38 143 783 720 815
570 34 538 571 597 748 494 779 589 624 988 989 990 66 67 631 34 634 630 748 592 67 720 102 103 815 67 720
67 67 67 14 628 539 571 630 65 67 64 67 64 67 596 629 67 14 628 597 67 67 67 67 782 67 782 67
67 720 70 38 71 78 75 599 538 571 630 67 720 596 629 782 76 143 67 628 34 538 34 597 720 67 67 67
71 70 6 6 38 6 109 493 513 497 628 538 570 629 67 140 72 137 67 67 720 816 817 628 34 630 782 679
38 6 38 38 103 46 626 579 487 617 719 67 67 67 67 142 868 38 45 720 783 848 849 720 782 628 539 570
102 111 111 103 743 655 579 416 386 496 782 868 66 784 785 102 38 103 67 782 815 782 784 785 720 720 743 591
67 720 67 591 580 425 582 423 494 560 70 71 868 591 577 497 46 67 720 782 816 817 782 67 67 591 426 583
783 67 655 419 386 618 779 589 782 70 6 6 71 559 587 577 529 784 785 720 848 849 67 70 71 559 459 553
815 67 430 544 429 560 64 679 66 102 38 6 143 64 559 451 545 561 720 783 782 720 67 142 143 493 746 592
67 67 559 423 465 65 66 64 14 720 102 38 137 66 64 430 424 492 718 815 742 67 67 102 6 45 64 685
67 720 679 748 560 66 66 44 6 71 782 102 103 66 626 580 616 615 577 613 576 497 775 777 168 71 99 100
70 71 64 65 932 71 66 743 102 114 45 66 66 685 591 459 492 582 587 578 556 617 561 720 108 103 800 66
6 38 71 70 38 932 591 425 497 66 742 684 685 684 559 746 494 615 555 450 588 577 465 66 100 66 782 674
38 6 6 38 103 626 417 618 496 591 426 497 66 66 64 65 67 559 587 482 416 386 465 66 67 67 67 66
6 6 38 6 71 782 495 577 613 646 618 592 66 66 66 66 67 64 559 587 423 585 481 529 100 67 67 67
38 6 38 38 103 66 559 619 544 494 592 720 66 66 742 742 67 67 64 559 423 480 746 716 718 67 720 67
102 103 102 103 66 66 782 689 530 624 720 66 66 655 426 618 529 66 14 65 558 590 956 957 958 66 67 70
67 720 67 67 66 66 66 64 720 782 66 66 14 430 522 494 592 70 38 71 64 751 988 989 990 66 70 6
71 67 67 782 67 70 71 70 82 71 66 70 103 495 616 561 165 142 6 6 71 67 64 67 64 782 111 38
6 71 67 67 720 113 6 6 6 6 82 103 655 416 717 496 162 142 38 114 6 71 782 67 67 782 67 868
38 38 71 67 74 134 38 38 38 38 6 71 430 616 429 592 66 102 103 720 113 38 71 67 782 67 868 67
