1c1d1e1f
14 20
653 684 198 295 306 305 231 684 653 685 100 626 715 746 560 132 903 904 905 463
198 337 435 209 804 67 67 266 272 267 100 932 65 684 775 777 935 936 937 559
435 205 238 804 324 337 327 837 433 237 132 685 100 132 64 132 967 968 969 132
232 303 720 198 303 782 234 304 301 744 688 652 653 132 720 132 332 333 132 132
236 265 198 295 235 99 132 932 527 497 572 652 685 132 132 596 539 34 538 570
198 305 231 742 99 99 99 655 616 528 604 538 570 34 570 629 392 301 782 132
231 44 591 545 497 743 680 581 623 465 601 685 684 653 66 676 230 263 272 262
100 557 614 746 615 453 714 592 748 560 632 132 685 132 132 228 672 300 294 176
711 748 719 568 559 558 941 942 943 711 599 630 132 132 132 132 132 674 132 230
679 64 64 696 64 64 973 974 975 64 932 2 132 132 782 132 132 132 132 782
64 100 3 36 101 782 1005 1006 1007 132 132 628 597 132 132 132 720 132 132 132
100 100 596 598 783 132 132 361 132 132 782 132 599 630 266 272 203 804 782 266
132 631 629 132 815 132 784 785 132 782 132 132 932 2 357 294 201 203 266 357
596 629 132 132 132 132 132 132 720 132 132 132 132 600 171 132 144 335 392 398
