1c1d1e1f
10 15
615 646 618 615 524 522 460 428 613 417 717 494 590 720 807
524 545 592 559 525 424 492 465 559 459 465 784 785 66 839
559 522 593 652 559 746 494 592 684 748 592 720 131 395 871
720 751 782 67 685 782 720 66 720 67 804 99 720 805 337
679 882 129 99 140 15 860 861 862 99 198 263 391 771 672
944 946 782 98 113 103 892 893 894 98 238 230 231 70 82
720 782 162 14 102 71 924 925 926 14 99 99 99 112 6
71 70 82 6 70 6 71 70 82 6 79 71 67 720 102
114 6 6 6 6 38 114 6 6 6 6 143 720 130 70
782 113 38 103 102 103 70 6 38 103 102 103 99 67 102
