53005455
22 32
909 814 815 813 847 815 813 814 815 909 814 815 813 814 815 879 849 433 209 853 231 53 56 238 230 231 268 274 199 23 276 213
845 846 847 845 846 847 845 846 847 845 846 847 845 846 847 945 401 433 205 885 209 91 245 52 98 204 717 718 719 209 123 245
877 878 879 877 878 879 814 815 424 423 878 879 845 878 879 945 433 192 176 853 199 27 87 24 66 236 749 750 751 67 21 26
909 910 911 975 973 815 846 847 452 457 845 845 814 815 815 879 817 401 231 885 752 209 130 99 67 759 781 782 783 760 206 67
941 942 722 941 975 879 941 942 943 941 975 879 877 814 815 847 945 752 199 882 818 819 819 851 227 791 872 724 726 871 792 850
973 974 754 847 845 846 847 974 975 973 974 975 456 877 878 879 945 433 192 209 238 204 199 882 851 195 758 726 724 231 850 883
877 877 813 879 814 815 846 847 813 814 974 941 878 452 486 879 945 401 720 199 268 177 192 199 853 904 904 752 752 209 853 752
813 813 845 846 847 877 878 879 814 877 878 845 974 879 420 845 845 817 401 401 401 192 401 752 882 821 720 401 231 820 883 192
909 814 815 909 910 911 787 723 877 454 426 877 941 878 456 975 877 878 881 817 401 401 401 401 199 264 401 401 199 206 264 720
845 846 847 941 942 943 845 846 847 420 877 878 909 910 878 456 975 846 911 974 881 817 401 433 401 401 401 401 433 433 401 816
877 878 879 973 974 975 424 423 877 452 426 814 941 942 943 878 452 486 975 845 878 845 881 881 817 401 401 816 881 881 881 879
909 910 878 878 847 420 816 817 423 422 975 878 973 974 975 878 877 878 456 975 845 974 909 878 846 881 881 814 879 877 878 815
845 846 847 813 814 877 845 877 877 877 877 427 455 452 426 878 813 877 878 456 975 975 909 910 879 879 814 878 973 879 815 813
877 878 879 845 846 847 877 813 814 846 427 453 877 846 847 846 845 846 847 878 452 975 846 427 457 845 846 847 813 846 847 813
846 909 910 877 878 879 911 813 813 815 975 421 877 878 420 423 877 878 879 847 845 456 486 453 814 815 813 814 815 814 879 813
813 941 942 943 877 878 879 813 814 813 427 453 909 422 976 977 423 877 878 879 813 814 815 814 814 909 975 879 813 814 815 813
877 973 974 975 909 910 911 813 813 877 786 877 941 452 488 486 455 909 910 911 845 846 813 814 815 975 846 909 879 815 845 909
813 813 845 846 975 427 457 456 426 814 847 723 877 974 941 846 878 941 942 943 877 878 845 846 847 456 486 426 877 425 877 975
909 814 815 813 456 457 813 814 847 878 813 845 813 815 877 878 879 845 974 975 909 910 877 878 879 909 878 454 488 457 815 909
909 910 911 845 846 847 845 846 847 845 877 877 846 814 723 910 845 878 878 878 941 942 943 878 879 877 878 846 941 942 943 909
941 942 943 846 878 879 877 878 879 813 814 879 814 846 755 942 943 813 814 813 909 909 909 910 845 813 814 878 973 974 975 877
973 974 975 813 814 815 909 910 911 813 813 815 813 878 973 974 975 814 846 814 975 909 975 942 943 845 846 847 813 814 815 813
