01020304
24 32
213 276 276 276 276 276 276 276 276 276 276 276 276 276 276 245 212 58 720 198 503 782 720 849 849 672 782 102 114 103 46 102
213 213 276 276 276 276 276 276 276 276 276 213 213 213 213 84 86 20 66 270 508 720 132 720 720 782 674 720 941 942 943 76
213 213 245 276 213 213 276 276 276 276 276 213 213 277 20 100 132 268 198 401 231 782 672 773 816 817 100 132 973 974 975 174
213 277 212 276 276 213 213 276 276 276 276 276 245 22 132 202 274 433 433 433 199 206 132 849 932 67 131 14 1005 1006 1007 174
212 212 212 213 276 276 213 213 213 213 276 213 277 54 66 234 306 433 433 433 433 433 209 67 720 640 70 38 71 14 70 82
276 277 244 276 213 213 213 213 213 213 213 277 277 214 199 100 132 144 231 300 239 301 132 131 642 44 114 103 113 6 38 6
276 276 213 213 276 213 276 213 276 213 213 212 312 401 401 209 100 230 506 67 132 70 82 71 676 741 773 677 932 113 6 114
276 276 276 276 276 84 86 276 213 277 283 315 214 401 401 508 132 66 301 132 100 102 114 6 71 100 67 70 82 932 103 741
23 84 86 84 26 720 901 27 212 312 401 401 401 401 247 313 58 119 55 58 55 52 100 113 81 672 163 102 81 131 677 816
507 199 67 100 720 782 162 132 217 214 401 401 247 313 277 277 213 213 213 213 212 22 70 6 103 14 674 772 102 71 132 848
437 903 904 905 132 132 132 132 302 401 401 401 282 213 213 213 213 213 213 213 245 52 102 6 82 6 79 135 134 103 720 132
401 935 936 937 206 132 132 132 234 232 401 247 213 213 213 213 213 213 213 245 245 213 56 102 103 102 103 102 114 82 77 162
239 967 968 969 144 199 198 209 132 249 313 244 213 213 213 213 213 283 213 213 213 213 245 54 119 132 782 140 134 81 132 720
132 132 230 273 401 177 231 208 804 21 213 213 213 213 213 213 214 305 279 245 213 213 213 213 245 54 44 38 6 103 783 132
132 996 358 230 231 163 132 260 804 55 276 213 213 213 213 312 179 3 178 279 213 213 213 213 213 26 132 102 81 720 815 675
529 742 742 132 67 132 100 366 367 125 213 213 213 213 213 213 56 53 54 249 213 283 213 213 277 56 132 70 103 132 673 816
551 424 618 719 132 67 132 292 261 125 213 213 213 213 213 245 277 245 245 245 216 304 217 213 213 22 100 102 82 45 132 848
582 424 592 685 100 132 132 260 293 23 213 213 213 213 213 213 245 245 213 312 303 4 249 213 245 54 132 99 102 71 132 132
494 590 132 100 198 199 198 231 132 55 213 213 213 213 213 213 213 213 213 245 248 249 245 245 245 245 56 720 100 42 99 631
163 67 100 132 144 401 231 198 199 27 22 27 213 213 213 213 213 213 213 213 213 213 245 212 245 245 638 565 539 34 539 598
742 132 208 273 401 401 199 270 401 275 206 132 25 87 276 277 213 245 213 213 245 245 84 85 283 283 22 162 100 720 817 848
992 561 163 230 231 230 177 231 270 401 433 275 132 132 27 84 85 86 85 86 87 26 132 198 433 433 209 880 817 816 814 785
616 465 686 742 742 132 100 208 401 433 231 238 67 208 199 198 199 100 132 67 100 198 145 401 433 231 783 848 814 914 849 132
512 492 582 579 992 561 132 67 230 231 132 100 132 132 230 177 433 199 67 198 199 144 177 433 176 720 815 848 849 817 932 932
