01020304
26 28
302 271 131 685 559 545 492 465 782 783 782 720 70 71 14 165 70 71 165 720 684 559 524 424 615 451 587 522
302 433 199 98 591 456 492 465 814 815 70 82 38 6 81 44 932 6 109 99 165 782 559 589 559 715 524 424
236 401 176 130 559 524 545 492 497 720 113 38 6 102 6 45 113 114 45 67 67 206 98 132 720 132 559 746
198 433 307 132 685 495 456 429 496 99 102 103 142 71 46 67 932 742 782 67 130 230 199 130 131 132 67 685
270 231 98 99 591 524 417 492 528 165 15 141 102 38 45 720 778 513 497 720 130 198 177 261 99 99 165 67
270 145 199 99 495 417 618 429 528 98 102 6 79 6 71 679 711 559 513 497 67 331 332 333 67 67 67 132
230 401 271 99 559 456 492 492 496 98 70 38 6 38 720 685 684 711 495 545 497 67 165 366 367 206 165 131
720 144 271 130 684 495 545 429 592 66 142 6 38 6 82 845 846 847 495 459 429 497 198 433 145 433 327 165
198 401 231 66 591 524 424 528 685 70 6 38 6 38 6 877 878 879 495 459 429 496 933 433 433 231 131 165
230 433 199 98 559 525 456 528 782 172 47 113 38 114 38 909 910 911 495 616 429 496 306 177 433 205 165 98
198 401 231 130 685 559 587 512 497 66 67 102 80 98 102 114 114 685 495 545 429 592 131 99 300 365 640 98
144 231 782 132 67 684 495 587 512 497 686 742 784 785 742 742 742 591 417 618 592 132 130 130 334 335 676 782
230 199 198 199 165 99 559 524 587 578 514 512 497 655 616 581 616 583 424 465 674 769 67 130 364 365 67 672
165 230 307 301 131 99 66 559 525 587 588 556 578 616 460 429 716 779 746 592 685 67 99 130 903 904 905 162
768 673 165 98 67 132 66 66 559 715 524 587 556 617 460 592 685 782 98 99 131 130 131 132 935 936 937 99
165 198 199 67 782 642 66 66 685 684 559 525 587 522 496 684 720 206 165 720 132 99 99 99 967 968 969 99
720 270 307 66 67 676 720 66 66 66 66 559 524 424 496 66 198 933 199 98 131 165 132 67 198 176 99 165
198 433 199 98 67 67 768 675 672 773 66 66 559 746 592 204 433 177 231 99 99 130 132 260 177 231 836 66
230 433 433 273 199 130 131 132 782 66 132 132 130 816 817 264 271 66 131 99 131 99 130 292 390 720 366 367
162 144 401 433 401 275 163 164 66 66 66 131 130 848 849 306 231 99 67 131 130 98 130 804 130 332 333 130
99 230 433 401 433 401 205 903 904 905 66 67 130 99 67 99 67 67 67 99 67 130 782 366 367 130 331 198
686 132 230 433 231 300 235 935 936 937 131 720 130 99 132 132 99 66 260 261 198 199 392 292 390 198 199 144
424 561 685 238 67 100 130 967 968 969 131 132 98 507 473 508 131 505 293 292 231 230 435 199 198 401 724 433
616 465 684 720 132 66 133 131 366 367 260 261 198 435 724 436 473 231 720 804 132 99 144 724 724 433 724 177
512 492 529 742 686 685 66 67 292 337 293 292 293 230 177 724 724 261 165 131 132 782 230 724 176 230 231 720
587 578 617 613 424 561 782 99 130 99 132 132 67 67 99 230 231 238 98 165 132 99 133 230 231 784 785 98
