01020304
17 30
579 616 460 582 524 451 459 551 417 646 615 524 459 496 782 131 67 600 66 631 598 70 6 6 103 46 903 904 905 784
587 617 428 429 583 549 616 582 424 592 559 715 746 592 643 99 99 599 570 605 720 102 38 81 804 66 935 936 937 130
524 522 460 428 613 417 717 494 590 720 903 904 905 66 100 99 164 14 66 600 782 131 102 103 361 782 967 968 969 66
525 424 492 465 559 459 465 784 785 66 935 936 937 804 675 99 76 6 71 2 14 720 14 66 66 66 208 177 145 199
559 746 494 592 684 748 592 99 204 199 967 968 969 67 643 163 70 6 80 600 112 82 6 71 676 773 505 473 231 230
685 782 720 66 720 67 99 131 264 805 337 293 131 99 677 499 142 167 107 696 102 103 102 103 131 99 230 401 145 199
140 15 860 861 862 99 198 145 176 771 672 773 675 771 782 70 6 71 99 599 34 570 630 198 275 269 198 433 401 433
113 103 892 893 894 98 238 230 231 70 82 79 71 70 71 102 38 143 67 70 103 388 2 231 230 401 433 305 177 231
102 71 924 925 926 14 99 99 99 112 6 6 6 6 103 163 168 103 99 102 71 99 600 131 99 230 231 66 66 131
70 6 71 70 82 6 79 15 79 103 102 6 114 6 71 100 70 80 720 70 103 131 564 99 162 57 52 117 118 164
6 38 114 6 6 6 6 143 173 130 70 6 45 166 6 82 167 107 131 46 131 66 636 54 57 244 245 244 245 54
102 103 70 6 38 103 102 103 99 67 102 103 99 70 114 103 784 785 208 199 116 53 212 212 244 213 213 213 213 245
100 162 102 6 6 71 131 99 131 99 640 99 76 81 720 164 198 199 206 144 215 212 244 213 213 213 213 213 213 213
57 52 118 46 102 103 99 903 904 905 672 773 99 102 71 164 144 401 401 401 247 244 213 213 277 276 277 276 213 277
125 244 245 54 119 99 131 935 936 937 164 900 676 44 6 77 230 433 433 247 244 213 213 277 283 212 216 217 212 214
244 213 213 245 124 131 66 967 968 969 206 361 260 836 113 77 53 347 350 244 213 213 277 216 304 217 54 57 26 933
213 213 213 213 245 56 66 132 144 145 177 145 231 70 6 137 25 212 244 213 213 277 216 299 933 236 314 212 52 230
