01020304
19 19
66 66 720 66 66 782 720 783 559 491 492 460 492 592 720 133 102 103 102
782 66 198 199 66 66 900 815 685 495 544 428 465 685 67 854 855 856 70
199 198 807 808 809 332 333 133 65 495 520 544 460 497 99 886 887 888 102
230 295 839 840 841 332 333 684 653 495 587 454 428 496 783 918 919 920 70
804 132 871 32 873 206 331 742 742 495 523 416 717 528 66 44 6 82 38
673 132 198 177 337 231 591 580 580 612 416 618 428 528 672 773 102 6 6
720 130 144 209 674 772 559 715 524 524 616 428 460 496 782 815 768 102 6
71 198 433 199 163 804 804 782 559 524 545 492 492 496 685 783 720 70 38
137 230 231 144 145 231 99 720 684 495 491 428 492 592 684 815 67 102 114
6 45 332 176 238 67 66 836 720 559 619 544 492 497 720 70 82 71 70
6 82 71 144 145 199 198 231 742 591 587 422 492 465 66 102 38 103 142
6 38 103 144 231 230 231 591 616 583 417 618 553 545 497 70 81 206 102
38 103 198 176 198 199 67 559 545 492 618 716 551 424 528 102 103 366 367
6 82 230 433 176 238 99 66 559 545 496 720 559 746 592 208 273 369 782
102 114 45 144 231 720 673 672 773 748 592 784 785 163 775 777 270 231 720
199 198 145 433 506 507 199 782 720 70 79 82 71 202 207 933 401 209 742
230 231 230 933 436 437 176 206 66 102 114 103 46 264 401 177 932 655 616
720 720 643 144 401 401 401 401 145 199 198 199 66 230 176 67 591 616 460
785 772 675 230 401 433 231 230 177 305 231 230 263 262 433 199 495 545 492
