01020304
32 32
213 213 213 213 213 213 212 315 212 212 212 244 213 277 26 23 84 85 86 276 213 213 277 276 213 213 212 87 89 276 213 213
213 277 276 213 213 277 214 401 215 212 244 213 277 26 99 130 784 785 14 27 276 277 212 212 276 277 26 66 131 27 276 213
277 212 212 276 277 280 401 933 247 244 213 277 124 198 932 720 14 932 113 71 123 212 20 27 212 124 98 720 932 71 27 276
212 212 212 87 212 212 246 401 314 276 213 277 280 176 206 44 114 82 81 46 125 22 98 130 21 212 54 44 82 81 55 212
245 212 22 14 21 212 212 313 212 315 212 213 277 246 176 59 54 102 103 59 26 99 130 782 206 27 212 58 102 103 125 244
277 124 44 81 14 27 212 212 280 401 215 276 245 212 313 244 245 58 55 124 206 720 268 933 231 162 125 212 54 59 277 213
212 212 54 102 932 71 123 212 312 401 932 215 276 245 244 213 213 245 212 280 401 205 230 176 99 98 23 212 276 244 213 213
212 212 212 54 102 103 125 276 245 246 401 247 213 213 277 276 213 277 276 245 246 201 203 932 205 116 53 212 244 213 213 213
27 212 212 212 52 59 212 244 213 212 313 212 212 214 215 20 23 88 214 314 212 246 265 144 237 123 245 244 277 276 213 213
98 27 87 212 212 212 244 213 213 213 245 277 312 177 176 98 720 208 401 215 212 312 401 176 55 244 213 277 20 23 276 277
882 98 66 21 212 244 213 213 213 213 277 212 26 98 230 209 99 66 230 401 215 212 281 313 212 84 86 26 70 71 21 212
914 720 99 66 23 276 213 213 213 245 212 212 54 198 99 66 642 98 198 401 401 215 244 245 22 70 71 70 114 6 45 123
946 98 782 99 66 125 276 213 213 213 245 212 214 176 782 198 506 98 230 401 177 247 276 122 67 102 6 81 932 103 720 125
720 98 99 720 98 27 244 213 213 213 213 277 246 401 145 177 501 816 817 144 209 23 212 245 52 118 46 102 81 782 98 27
199 932 98 98 116 53 276 213 213 213 277 88 214 401 176 640 98 848 849 230 199 98 21 89 245 212 52 118 46 196 116 53
231 66 720 98 21 212 213 213 213 277 26 98 502 401 401 209 44 82 45 198 176 782 98 98 125 245 212 212 54 59 244 245
783 98 98 198 145 215 213 213 277 124 206 99 66 230 231 14 720 46 198 401 231 98 720 98 27 276 245 244 245 244 213 213
815 676 470 401 401 247 244 277 212 214 401 199 206 44 82 6 103 208 401 401 199 98 932 66 59 213 276 213 213 213 213 213
99 66 238 144 401 282 276 245 280 401 933 401 401 199 102 38 71 643 230 401 231 208 145 471 125 244 277 276 213 213 213 213
98 116 53 246 401 314 276 213 212 246 401 401 401 231 44 114 103 468 199 144 209 198 247 313 213 277 214 215 212 212 213 213
55 212 244 245 313 88 212 276 245 312 401 401 247 52 57 54 470 437 401 932 208 401 314 213 277 214 401 177 215 88 276 213
212 244 213 277 20 98 125 244 213 245 313 246 314 244 245 212 281 313 246 401 145 247 244 277 312 401 231 932 331 720 27 276
244 213 277 26 99 130 23 276 213 213 245 212 244 213 277 212 212 244 245 246 247 244 213 212 214 176 782 274 199 131 55 244
213 277 26 98 720 782 98 27 276 213 213 245 277 315 214 215 315 89 213 245 244 213 277 212 246 231 932 230 176 57 244 213
213 245 52 99 130 720 70 71 21 276 213 213 312 401 401 401 401 199 27 276 277 214 215 315 124 99 66 720 238 125 213 213
213 213 245 58 98 70 932 113 71 27 87 276 213 246 231 230 401 401 199 123 280 401 401 247 212 54 98 162 53 244 213 213
213 213 213 245 54 102 114 6 103 98 14 23 213 26 98 932 238 933 231 125 212 246 401 215 87 212 52 59 212 212 276 213
213 213 213 213 212 52 118 46 782 70 6 71 123 54 720 99 66 782 55 280 215 214 231 238 98 27 212 276 213 245 212 276
213 213 213 213 213 245 124 98 70 932 113 103 125 212 52 784 785 720 125 312 177 231 932 82 45 782 123 212 276 213 245 212
213 277 212 276 213 213 245 54 102 114 6 45 123 244 245 52 116 53 212 124 100 70 82 81 720 100 125 244 244 213 213 245
276 212 212 244 213 213 277 122 98 44 103 59 244 213 213 245 212 212 244 245 52 102 6 6 45 55 212 276 213 213 213 212
212 244 213 213 213 277 212 212 52 118 55 212 213 213 213 213 245 244 213 213 245 52 102 103 59 212 212 212 276 277 212 212
