01020304
10 27
38 71 132 132 684 685 653 684 685 168 6 114 103 685 653 684 685 653 559 715 715 524 587 513 428 582 522
166 103 99 132 99 100 67 132 685 108 103 807 808 809 70 135 141 132 67 132 684 559 715 715 513 615 616
132 99 70 77 132 132 99 100 132 132 99 839 840 841 113 38 6 82 79 71 132 851 852 853 463 517 578
14 132 168 109 132 99 100 132 164 14 132 871 32 873 102 103 102 6 6 103 132 883 884 885 495 524 587
6 71 72 71 99 100 132 14 44 6 82 71 230 199 66 198 205 113 103 14 132 915 916 917 559 715 524
38 6 6 103 70 82 82 6 82 38 6 103 131 144 209 270 265 102 82 6 82 77 99 66 65 684 495
102 111 111 82 111 111 111 111 105 102 6 45 163 144 209 230 231 70 38 6 105 66 14 99 66 66 495
54 720 170 46 55 52 117 118 70 82 81 66 208 176 66 198 209 102 6 38 109 162 102 79 71 685 495
245 56 100 57 244 244 212 26 102 38 114 71 66 230 273 176 132 132 102 103 119 782 720 113 103 720 559
213 124 55 244 213 277 276 54 76 81 782 113 71 66 230 231 132 53 58 55 26 66 70 103 784 785 65
