0e007210
19 21
475 475 475 475 403 410 506 475 475 475 475 475 475 475 475 475 475 475 475 475 475
475 475 475 539 222 441 475 475 475 475 475 475 475 475 475 475 475 475 475 475 475
475 475 539 251 252 253 254 475 475 539 475 475 475 475 475 475 475 475 475 475 475
475 539 282 283 284 285 286 287 539 506 475 475 475 475 475 475 475 475 475 475 475
475 507 314 353 414 358 318 319 506 475 475 475 475 475 475 475 475 475 475 475 475
475 539 281 385 317 317 360 280 506 475 475 475 475 475 475 475 475 475 475 475 475
475 475 313 445 317 317 382 248 506 507 475 475 475 475 475 475 475 475 475 475 475
475 475 313 445 317 355 414 312 474 475 475 475 475 475 475 475 475 475 475 475 475
475 539 281 445 317 387 413 312 474 475 475 475 475 475 475 475 475 475 475 475 475
475 507 281 445 317 355 414 312 474 475 475 475 475 475 475 475 475 475 475 475 475
475 539 281 445 317 387 413 312 474 475 475 475 475 475 475 475 475 475 475 475 475
475 507 249 445 358 358 317 312 474 475 475 475 475 475 475 475 475 475 475 475 475
475 539 249 360 412 358 386 248 474 475 475 475 475 475 475 475 475 475 475 475 475
475 507 473 339 344 343 339 473 474 475 475 475 475 475 475 475 475 475 475 475 475
475 506 372 373 374 375 376 377 507 507 475 475 475 475 475 475 475 475 475 475 475
475 475 404 405 406 407 408 409 475 506 475 475 475 475 475 475 475 475 475 475 475
475 475 507 437 438 439 440 506 475 475 475 475 475 475 475 475 475 475 475 475 475
475 475 475 507 602 602 506 475 475 475 475 475 475 475 475 475 475 475 475 475 475
475 475 475 475 474 474 506 475 475 475 475 475 475 475 475 475 475 475 475 475 475
