0e007210
31 21
475 475 875 608 609 610 614 615 616 481 481 419 419 288 419 545 521 518 522 743 744
475 475 876 640 641 642 646 647 648 481 578 202 201 578 578 192 521 452 522 775 776
475 475 875 109 288 288 288 288 288 578 876 422 199 192 192 192 521 484 522 192 192
475 539 875 617 549 549 549 549 427 288 876 454 518 554 578 192 521 516 522 419 288
539 474 876 453 740 741 737 865 866 554 876 454 484 522 192 578 521 518 522 192 419
474 474 875 453 772 773 769 897 898 455 876 454 484 518 554 192 521 518 484 554 192
506 507 875 454 518 484 549 518 548 582 876 454 484 484 484 457 518 484 452 522 225
538 539 875 389 389 911 877 912 389 389 876 454 518 518 580 580 484 580 484 580 520
877 877 845 486 548 937 938 939 548 582 844 878 878 878 877 912 389 389 389 911 878
548 548 548 518 518 969 970 971 484 518 548 548 555 457 548 555 484 484 548 548 555
518 484 518 580 580 580 580 518 580 484 580 518 518 580 580 518 580 484 484 580 580
389 389 911 878 878 877 878 912 389 389 911 878 878 878 877 878 912 389 389 911 877
548 548 549 549 488 428 549 420 488 549 520 420 548 555 548 549 549 580 518 548 420
580 584 911 878 877 878 877 878 877 878 877 912 422 580 584 911 877 877 878 878 877
591 218 368 474 474 474 403 410 474 474 474 366 217 558 218 368 367 474 474 474 474
590 220 507 506 507 506 222 441 507 474 506 475 219 526 220 475 507 474 507 403 410
589 220 475 475 475 251 252 253 254 507 475 475 219 526 220 475 475 507 474 222 441
591 220 475 475 282 283 284 285 286 287 507 475 219 558 220 475 475 475 251 252 253
558 218 475 475 314 353 358 358 318 319 475 474 217 526 218 475 539 282 283 284 285
590 220 475 507 346 385 317 317 386 351 475 507 219 558 220 475 507 314 315 358 358
558 220 475 539 378 445 317 317 317 390 359 359 391 558 220 475 539 346 360 350 317
590 220 475 539 281 445 317 355 414 280 474 506 219 589 390 359 359 391 446 317 317
590 390 359 359 391 445 317 387 413 280 506 475 217 589 390 359 359 391 445 317 355
558 390 359 359 391 445 317 355 414 312 507 474 219 558 220 475 506 281 445 317 387
590 220 475 507 281 445 317 387 413 390 359 359 391 558 220 475 539 281 445 317 355
589 220 475 539 281 445 358 358 317 390 359 359 391 558 220 475 507 281 445 317 387
590 218 475 539 249 360 412 317 360 248 475 474 217 589 218 475 475 281 445 358 317
589 220 539 507 307 244 344 343 277 339 506 474 219 557 220 475 475 249 360 360 386
558 220 474 539 372 373 374 375 376 377 475 474 219 557 220 475 539 307 244 344 343
589 220 474 475 404 405 406 407 408 409 475 474 219 557 220 539 538 372 373 374 375
558 218 506 475 507 437 438 439 440 506 474 474 217 591 218 474 474 404 405 406 407
