0e000f10
16 17
718 981 622 622 622 622 622 622 622 622 622 656 657 981 98 981 717
687 527 528 528 354 560 528 528 528 528 528 528 687 527 129 527 687
687 559 525 557 592 525 589 557 525 589 557 525 687 559 528 525 687
622 622 559 622 717 559 64 559 64 559 64 559 687 559 557 558 687
528 528 589 528 687 559 528 558 528 526 528 589 687 559 589 590 687
388 589 557 525 718 981 559 622 622 622 559 622 622 622 559 622 749
748 622 622 559 654 979 389 976 687 979 389 976 976 976 389 976 687
687 979 976 389 687 454 518 554 654 527 528 354 560 354 560 528 687
687 454 548 554 654 454 944 422 420 526 525 592 525 592 525 525 687
654 486 518 452 420 452 548 518 687 559 557 352 561 352 561 557 687
548 452 452 518 718 981 454 688 689 559 526 592 525 592 525 589 687
518 518 452 452 654 454 518 555 687 559 589 590 589 590 589 590 687
164 452 452 518 420 452 64 422 718 981 622 622 622 622 622 622 749
622 982 422 452 982 622 622 622 749 979 976 976 976 976 976 976 978
976 977 486 484 977 976 976 976 978 45 110 110 110 14 128 132 209
128 128 164 452 133 128 128 416 128 128 79 45 101 202 196 302 302
