0e000f10
21 15
225 675 612 677 808 806 810 865 866 876 422 518 489 423 518
225 707 644 709 840 838 842 897 898 908 454 522 578 521 516
132 555 548 520 555 423 520 520 520 555 516 516 555 516 516
164 239 165 225 234 235 225 578 578 521 518 516 516 518 516
225 225 909 814 912 814 912 814 912 461 516 911 877 912 461
419 458 907 454 808 806 810 744 747 516 522 678 615 680 164
555 582 907 454 840 838 842 776 779 516 522 710 647 712 202
518 489 909 454 555 423 555 555 555 518 516 555 555 520 302
522 578 907 454 518 489 489 489 518 516 518 516 522 419 521
522 419 907 454 522 672 609 674 521 516 518 808 806 810 865
516 555 909 454 522 704 641 706 521 489 516 840 838 842 897
518 516 907 454 518 520 555 555 522 578 521 555 516 555 555
516 518 907 454 522 419 521 518 516 555 518 229 238 812 650
713 422 713 454 713 649 650 650 713 422 516 713 649 682 714
651 389 651 389 651 714 683 683 651 389 389 651 714 715 454
520 548 548 548 548 548 548 548 548 548 520 520 520 548 516
578 521 516 518 516 518 516 518 516 522 419 578 419 521 518
912 814 912 461 516 516 518 911 877 911 877 911 877 912 461
865 866 548 516 518 516 516 548 548 864 865 936 806 807 516
897 898 516 518 516 518 516 518 516 896 897 968 838 839 489
555 555 518 516 516 516 518 516 516 555 555 555 516 427 419
