0e000f10
24 28
877 877 845 66 521 516 489 522 128 876 474 475 538 475 538 876 454 516 516 518 516 516 587 876 538 538 475 475
672 609 674 128 521 522 419 490 128 911 877 911 877 912 877 912 486 516 516 516 516 953 952 908 538 475 475 475
704 641 706 553 516 516 554 419 553 457 548 548 548 457 548 548 516 516 489 516 522 525 394 983 538 475 475 475
428 549 428 516 518 516 516 457 516 518 516 516 516 516 516 516 516 586 419 521 522 557 558 983 538 475 475 475
675 612 677 521 516 516 489 489 516 516 580 580 580 516 518 516 522 419 553 516 522 525 352 983 538 475 475 475
707 644 709 521 516 522 128 416 521 911 877 911 877 912 877 946 422 457 516 516 516 985 986 876 538 538 475 475
457 548 457 516 516 522 128 128 521 795 538 475 538 475 538 876 454 516 516 516 516 484 552 876 538 538 538 475
518 516 516 516 516 516 554 128 521 478 539 538 539 538 539 876 454 516 987 302 302 484 582 844 877 813 538 475
516 518 516 516 516 518 516 457 302 478 474 475 475 507 474 844 877 880 461 795 509 794 302 548 548 876 538 475
580 580 580 516 518 516 516 302 795 474 474 475 475 507 507 365 366 368 509 474 474 508 302 484 484 876 538 475
808 806 807 516 516 516 302 795 538 538 475 475 475 475 475 538 538 538 538 538 538 538 794 844 877 845 538 475
840 838 839 516 516 302 795 474 538 475 475 538 538 538 538 538 474 474 474 538 538 538 538 365 367 368 538 475
549 516 457 516 516 795 474 474 474 474 474 474 762 763 474 474 474 474 474 474 474 538 538 538 538 475 475 475
813 422 516 516 302 763 474 474 474 812 877 877 880 461 763 479 511 479 844 877 813 474 538 538 475 475 475 475
876 454 516 516 302 795 474 474 474 876 808 806 807 516 302 302 302 493 352 352 876 474 538 475 475 475 475 475
876 454 518 516 302 478 474 474 474 876 840 838 839 516 516 516 516 522 592 354 876 474 538 475 475 475 475 475
876 454 516 516 795 474 474 474 474 876 553 516 457 516 516 516 516 582 525 592 876 538 538 538 475 475 475 475
876 454 516 302 510 474 474 474 474 844 877 877 813 422 516 518 516 582 525 525 876 474 474 538 538 475 475 475
876 454 516 302 763 474 474 474 474 365 368 365 876 454 516 516 516 582 525 525 844 877 877 813 538 538 475 475
845 486 516 582 911 877 912 877 912 877 912 877 912 486 516 516 489 516 552 558 525 386 352 908 538 538 475 475
548 518 516 518 457 548 548 457 548 457 548 548 548 516 518 586 578 521 582 525 558 525 592 983 538 475 475 475
518 516 516 516 587 580 489 489 489 587 580 518 518 516 522 419 128 521 516 525 558 525 525 983 538 475 475 475
516 516 516 582 945 877 912 877 912 877 912 877 946 422 516 457 457 518 582 558 525 525 352 983 538 475 475 475
516 518 516 522 876 475 538 475 538 538 475 538 876 454 518 516 518 516 522 525 558 386 592 876 538 538 475 475
