3c00683e
10 15
612 459 534 686 749 592 749 654 420 459 710 1 338 337 337
704 459 823 749 563 623 563 749 823 459 705 2 296 337 463
736 459 820 822 500 595 469 822 822 459 737 2 264 337 491
704 459 782 820 596 625 628 822 719 459 705 2 402 403 459
768 552 588 820 596 625 628 822 587 553 769 433 460 460 484
426 426 426 484 560 627 689 484 426 426 553 823 824 825 551
554 554 484 516 452 454 453 516 484 555 554 820 822 822 486
824 824 516 823 825 824 825 824 516 823 824 822 822 822 486
822 822 824 821 822 822 822 822 825 821 822 821 822 822 463
821 822 822 822 822 821 822 822 821 821 822 463 426 426 553
