ae00afb0
16 30
42 168 235 236 237 238 239 168 111 171 224 163 132 66 417 160 291 325 66 70 162 131 39 100 68 100 138 139 100 67
42 43 168 268 269 270 168 171 111 171 224 131 39 104 485 416 323 102 39 66 70 70 71 66 66 103 34 137 1 2
74 77 44 300 301 302 44 78 142 171 224 98 39 66 166 323 68 38 104 66 454 164 66 106 108 164 66 70 71 256
12 109 43 44 43 44 43 110 45 44 224 98 163 66 198 36 38 98 39 256 420 68 101 68 140 485 484 259 258 160
43 74 75 64 65 97 141 142 171 44 224 70 71 66 132 66 38 98 104 419 227 66 66 66 132 320 290 449 416 160
43 12 12 12 12 12 12 12 44 44 166 4 67 38 39 66 70 71 258 420 422 66 38 39 66 101 320 228 386 292
166 14 43 44 44 44 43 44 44 166 198 36 38 71 101 66 258 196 160 420 100 38 130 131 39 66 66 101 34 322
198 64 65 65 65 65 65 65 97 230 453 106 70 135 256 196 449 416 160 160 259 70 162 163 71 106 100 67 66 38
260 418 106 66 130 131 131 135 194 482 389 66 66 417 160 291 228 448 292 160 160 257 105 71 34 258 257 66 38 130
160 257 34 102 38 131 71 34 290 420 68 101 39 485 291 325 66 132 320 290 160 160 418 66 34 226 449 486 162 163
290 160 261 38 131 71 70 106 322 227 100 38 131 320 323 66 38 39 34 322 288 160 486 66 103 421 387 325 70 71
322 419 420 70 101 34 66 34 256 293 68 70 163 106 66 66 70 98 39 34 228 448 325 166 4 132 34 132 66 66
484 160 227 66 1 2 102 485 452 228 132 38 131 39 66 166 4 70 71 66 66 132 34 198 36 38 39 66 66 66
160 160 293 34 102 98 39 320 321 137 38 163 71 71 454 198 36 66 166 106 134 67 66 66 38 130 71 66 454 68
160 420 325 38 130 98 71 66 66 66 70 71 260 196 289 68 101 101 198 487 257 66 66 67 130 98 39 106 419 259
160 160 257 70 162 71 135 258 196 486 34 258 160 420 321 134 1 2 34 384 419 196 259 38 130 98 71 34 292 160
