21002223
24 26
194 727 288 727 194 761 696 794 458 452 453 426 592 427 452 453 459 2 793 696 762 194 727 132 793 665
761 794 172 793 696 794 140 72 458 528 595 657 623 528 595 657 459 2 134 135 793 696 794 66 132 793
794 132 612 576 544 545 546 546 614 560 690 659 595 658 691 689 612 576 544 545 546 546 614 1 132 99
132 194 736 608 609 609 609 610 616 720 596 625 625 625 628 753 713 608 609 609 609 610 705 2 194 761
762 288 704 675 706 707 707 679 648 720 688 690 625 691 689 721 745 675 706 707 707 679 737 2 132 793
794 102 768 672 673 672 673 672 800 752 721 596 625 628 721 721 801 672 673 674 672 673 769 2 132 72
612 576 546 545 578 614 416 428 426 426 426 429 531 628 428 426 426 426 429 416 612 576 544 545 546 614
736 640 641 641 642 705 496 435 595 595 595 595 658 659 595 595 595 595 436 594 704 608 609 609 610 705
704 640 641 611 642 616 720 532 627 627 627 627 627 627 627 627 627 627 437 721 704 640 611 641 642 705
736 675 706 707 679 648 496 501 463 426 426 484 784 785 484 430 426 521 434 594 745 675 706 707 679 737
768 672 673 674 673 800 720 626 459 518 517 516 452 453 516 518 517 459 495 721 801 672 673 674 673 769
612 576 546 545 578 614 720 626 459 2 761 696 724 724 696 762 72 491 495 721 612 576 546 544 646 614
704 608 609 609 610 705 720 626 459 2 727 131 793 794 131 727 102 458 495 753 704 608 609 609 610 705
704 640 641 641 642 616 752 626 459 2 793 696 731 731 696 794 72 491 495 721 713 640 641 611 642 705
736 640 641 611 642 648 496 501 552 426 426 521 630 730 463 426 426 553 466 594 745 640 611 641 642 737
704 675 706 707 679 680 752 500 595 657 722 459 662 730 458 723 656 595 469 721 777 675 706 707 679 737
768 672 673 674 673 769 496 467 627 689 721 459 662 730 458 720 688 627 468 594 768 672 673 674 674 769
484 430 460 676 576 545 834 835 836 484 720 484 662 730 484 752 484 676 802 803 804 677 678 462 426 484
518 517 517 704 608 609 609 610 705 516 420 516 694 730 516 420 516 704 608 609 609 610 705 518 517 516
102 103 166 736 640 611 611 642 737 2 727 110 729 730 110 727 102 704 640 641 641 642 705 2 102 103
762 66 70 736 675 706 707 679 737 2 793 731 724 724 665 724 762 736 675 706 707 679 737 2 162 761
724 762 102 768 672 673 674 673 769 2 99 729 724 697 724 724 794 768 672 673 674 673 769 2 761 724
724 794 70 484 430 427 427 426 484 2 761 724 794 99 793 794 76 484 430 426 427 426 484 2 793 724
794 70 6 516 518 517 517 517 516 34 793 794 140 72 71 132 136 516 518 517 517 517 516 34 131 793
