21002223
10 15
823 463 427 427 484 555 528 595 657 554 484 426 427 521 823
463 484 523 522 522 528 658 625 659 657 522 522 522 484 521
459 523 555 554 554 898 899 899 899 900 554 554 554 522 459
459 555 528 896 825 485 864 865 867 485 823 897 657 554 459
491 528 658 928 821 423 724 724 724 421 820 929 659 657 459
459 530 625 928 822 422 726 724 724 486 820 929 625 628 459
491 560 690 928 822 484 630 724 724 484 820 929 691 689 459
552 484 688 960 822 516 452 454 453 516 820 961 689 484 553
523 552 426 426 484 823 825 825 825 825 484 426 427 429 523
555 522 522 522 459 528 595 595 595 657 459 523 522 522 555
