8800898a
25 23
18 18 18 18 18 18 18 18 18 139 98 291 100 140 18 18 18 18 18 18 18 18 18
18 18 18 18 18 18 18 139 161 166 130 323 132 160 161 140 18 18 18 18 18 18 18
18 18 139 161 161 161 161 264 391 178 275 274 276 178 391 265 161 161 161 161 140 18 18
18 18 167 391 101 101 101 345 177 114 176 240 272 114 177 346 391 101 101 101 170 18 18
18 18 167 8 6 6 6 232 176 146 209 272 240 146 209 233 8 6 6 6 170 18 18
18 18 167 7 5 178 7 160 178 176 240 240 240 240 178 166 7 178 7 5 170 18 18
18 18 167 7 5 264 7 101 114 74 75 75 75 76 114 197 7 265 7 5 170 18 18
18 18 167 7 5 345 7 6 144 6 6 6 6 6 144 6 5 346 7 5 170 18 18
18 139 178 7 178 160 161 161 161 178 7 66 7 178 161 161 161 166 178 7 178 140 18
18 167 264 13 264 489 224 230 203 264 7 6 5 265 489 224 230 203 265 13 265 170 18
18 167 345 13 345 395 256 262 197 160 161 161 161 166 395 256 262 197 346 13 346 170 18
18 167 232 8 232 8 6 6 6 203 461 51 462 203 8 6 6 6 233 8 233 170 18
18 167 264 7 264 7 5 5 5 197 493 83 494 197 7 5 5 5 265 7 265 170 18
18 167 345 7 178 7 5 178 7 6 6 334 6 6 5 178 7 5 178 7 346 170 18
18 167 232 7 114 7 5 264 7 5 5 5 5 5 5 265 7 5 114 7 233 170 18
18 167 264 13 114 74 76 345 162 7 164 133 162 7 164 346 74 76 114 13 265 170 18
135 84 345 8 144 6 6 232 194 45 196 392 194 45 196 265 8 6 144 6 346 90 140
167 116 232 7 5 5 5 264 103 45 174 424 103 45 174 346 7 5 5 5 265 122 170
199 148 441 7 5 5 5 441 258 45 206 391 258 45 206 442 7 5 5 5 178 154 202
313 167 162 7 164 162 7 164 236 45 238 391 236 45 238 162 7 164 162 7 164 186 314
264 167 194 45 196 194 45 196 204 269 270 6 268 269 270 194 45 196 194 45 196 186 346
345 167 103 45 174 103 45 174 51 7 5 5 5 5 51 103 45 174 103 45 174 186 346
161 178 258 45 206 258 45 206 83 74 75 75 75 76 83 258 45 206 258 45 206 178 165
193 114 236 45 238 236 45 238 145 41 75 75 75 76 145 236 45 238 236 45 238 114 197
6 144 268 269 270 268 269 270 5 5 5 5 5 5 5 268 269 270 268 269 270 144 6
