6a006b6c
22 22
774 774 777 943 1006 937 943 1007 937 943 814 815 784 817 818 943 937 964 998 937 943 1006
911 911 911 1006 1007 1003 945 1006 1003 945 846 847 848 849 850 943 1003 911 911 1003 945 1006
1006 1007 1006 1006 1006 1006 1007 1006 1006 1007 911 944 880 946 911 1006 1006 1007 1006 1007 1006 1007
1006 1007 1006 1007 1006 1006 905 779 907 943 1006 976 977 978 1006 1006 907 779 905 943 1006 1006
788 788 788 819 943 852 937 968 806 943 1006 1008 1009 1010 1006 1006 839 968 937 778 943 1006
103 198 70 38 143 198 1001 171 776 774 774 905 942 905 779 774 777 980 1001 806 943 1006
774 775 943 776 774 774 774 808 901 968 967 937 943 937 968 967 967 1012 198 839 943 1007
911 911 1007 911 911 911 911 911 839 980 100 1001 171 1001 171 100 100 100 14 839 943 1
1006 1 943 900 787 819 943 820 853 1012 44 79 79 71 198 70 79 43 103 839 943 911
1 974 1006 839 980 174 111 6 45 100 198 102 103 102 79 6 103 198 100 839 943 1
911 1006 1006 839 980 100 198 102 900 774 774 774 774 774 774 774 875 884 132 839 943 911
788 821 809 777 943 806 948 100 839 974 911 911 911 911 911 911 911 100 67 839 943 1007
38 73 839 974 1007 839 980 132 839 943 1006 1006 1007 1006 906 1006 806 948 99 839 943 1006
81 102 839 943 906 839 980 900 810 875 943 872 901 943 1006 1006 839 980 131 838 943 1007
103 198 852 788 788 853 1012 839 974 911 1006 911 842 787 788 788 853 1012 163 911 1007 1006
82 82 6 6 80 100 67 839 943 1006 1006 1007 839 980 74 141 198 198 134 806 943 1006
774 774 774 774 901 948 99 820 819 943 820 788 853 1012 108 111 43 43 103 839 906 1006
911 911 1 974 839 980 198 113 114 38 38 114 71 900 774 775 943 776 808 809 775 943
1006 906 911 1006 839 980 44 81 198 113 81 198 102 839 974 911 1007 911 911 839 980 100
788 819 943 820 853 1012 198 102 82 6 6 71 100 839 943 906 1006 906 1006 839 980 100
78 72 6 6 38 45 67 100 110 104 6 103 198 839 943 1006 1006 1007 1006 839 980 100
6 6 167 110 110 162 100 100 99 72 6 175 100 820 788 788 788 788 788 853 1012 198
