6a006b6c
27 29
70 38 103 66 66 162 66 130 98 100 66 165 130 98 198 100 163 752 722 100 163 163 100 100 163 100 430 617 582
114 103 780 900 902 774 775 774 775 774 775 901 781 130 66 100 655 721 682 745 100 960 960 960 100 591 579 544 615
71 100 812 807 870 782 783 882 785 786 871 807 813 883 66 100 753 528 657 744 750 163 100 100 163 430 587 616 582
81 70 908 839 974 814 815 914 817 818 974 839 909 947 44 71 751 560 65 679 163 100 163 743 591 579 416 717 461
103 112 940 776 901 846 847 848 849 850 900 777 941 915 70 143 64 64 140 64 163 163 591 491 583 587 423 429 494
82 80 972 844 807 974 944 880 946 911 839 845 973 947 168 38 82 79 38 45 100 679 495 523 544 581 616 560 64
6 6 1004 876 807 943 976 977 978 1006 807 877 1005 1011 174 38 38 38 169 198 198 65 559 715 423 429 592 64 74
6 38 6 908 839 943 1008 1009 1010 1007 839 909 947 66 70 38 114 111 109 711 744 750 64 198 751 560 100 163 106
38 6 38 940 776 905 910 1006 1007 905 777 941 915 44 38 80 748 744 750 198 64 198 100 198 64 65 98 98 163
38 38 6 972 935 937 943 1006 1007 937 936 973 947 70 114 103 679 64 171 132 655 625 198 98 99 960 139 960 130
81 6 38 1004 967 969 964 965 966 970 968 1005 1011 142 175 960 134 71 99 591 425 465 100 162 99 596 34 597 596
103 172 113 6 103 1001 996 997 998 1002 66 66 66 112 45 960 142 114 45 495 594 531 626 66 596 629 14 628 629
71 66 112 38 45 66 15 82 79 45 70 71 66 136 137 960 46 99 99 559 517 513 496 711 600 70 38 82 114
114 82 6 6 71 70 38 38 38 79 38 38 82 38 80 132 591 625 99 65 559 587 467 596 629 112 114 80 198
66 110 46 166 38 38 111 38 38 38 38 111 38 38 169 591 417 496 171 132 65 495 467 600 70 167 198 112 82
71 162 66 198 102 103 960 960 960 111 103 100 172 110 107 559 715 545 497 99 171 751 560 600 46 198 99 102 47
47 752 722 162 198 44 79 15 75 98 711 743 744 745 99 64 65 751 560 99 14 64 679 600 130 99 130 596 539
655 721 561 743 162 165 102 111 109 66 720 424 497 130 98 100 66 64 64 98 168 71 64 628 597 139 596 629 163
459 615 617 550 498 130 100 198 100 66 65 751 560 100 66 711 100 98 100 66 106 104 135 75 604 34 629 70 109
549 416 717 615 467 742 165 130 130 198 130 64 198 98 720 530 650 750 198 134 135 134 6 109 600 15 79 80 198
715 423 466 715 747 614 498 98 100 198 100 198 66 66 679 64 64 100 44 38 103 104 103 596 629 102 38 111 79
65 590 929 930 931 559 754 98 100 681 722 98 198 66 64 138 596 597 106 173 596 34 34 629 74 136 80 198 112
135 65 961 962 963 711 64 130 655 545 649 681 745 66 596 34 629 628 539 667 629 15 82 45 106 102 137 99 98
38 135 993 994 995 64 98 98 430 499 560 64 138 596 629 14 134 71 164 600 171 168 38 175 130 198 46 130 100
102 111 45 44 79 15 75 98 495 467 64 596 34 629 134 38 114 38 135 628 597 108 103 198 98 99 98 99 100
98 198 130 198 46 110 107 720 715 545 593 600 165 98 102 80 198 112 81 75 2 66 67 67 198 130 100 198 132
79 71 98 198 98 198 98 928 864 590 596 629 165 14 100 66 14 142 167 107 628 597 98 99 100 70 135 66 67
