3e003f40
32 23
3 4 685 559 587 512 429 429 551 580 545 429 582 522 429 528 73 444 407 225 756 752 752
2 36 206 684 559 587 545 429 582 524 555 512 586 522 460 496 105 444 436 350 287 350 346
10 38 178 147 684 559 522 494 560 559 587 556 578 616 428 560 73 476 381 382 319 383 349
42 10 4 270 725 684 589 684 653 654 559 587 588 578 544 497 105 724 784 720 720 720 720
36 35 36 178 305 719 725 3 814 5 684 559 715 587 423 496 67 721 718 718 718 718 750
4 601 538 501 503 161 755 35 502 501 500 533 193 559 622 592 73 756 816 752 718 718 718
10 535 65 72 162 98 98 163 105 35 2 564 533 193 684 100 98 105 164 101 756 752 718
10 567 34 17 18 19 164 17 18 19 35 40 535 34 105 104 164 67 3 4 164 164 756
42 535 34 49 50 51 723 49 50 51 3 601 538 500 501 500 565 161 35 10 502 533 193
42 567 65 66 753 719 752 720 719 754 35 535 65 66 73 35 36 104 101 35 4 535 256
42 601 538 501 500 503 161 396 98 98 101 564 503 161 501 533 193 17 18 19 40 567 224
35 567 65 72 132 98 332 333 98 105 753 719 725 66 11 535 65 49 50 51 3 535 224
674 535 65 130 17 18 19 292 205 564 533 193 721 725 35 567 97 720 725 3 2 567 288
705 567 65 98 49 50 51 146 303 35 535 65 756 718 725 535 129 177 722 35 39 535 97
769 535 34 98 146 147 146 401 241 3 567 34 146 750 722 567 65 66 360 66 3 567 129
640 567 34 146 718 750 179 178 237 37 535 65 270 718 722 535 65 17 18 19 35 567 65
3 535 65 270 718 271 502 501 500 501 565 96 433 718 601 629 225 49 50 51 66 535 65
35 567 34 270 718 752 719 754 753 719 754 236 718 722 535 65 146 720 205 66 105 567 256
6 535 65 270 271 564 500 500 501 500 533 193 178 722 535 34 296 601 503 161 501 629 226
3 567 256 401 401 147 102 17 18 19 567 65 204 722 535 34 364 567 65 70 73 100 98
10 535 288 179 238 292 725 49 50 51 564 533 128 722 567 34 146 564 501 501 533 193 146
10 567 34 217 218 219 292 145 725 6 2 535 34 722 535 65 178 179 753 725 567 256 718
35 535 34 249 250 251 146 718 750 209 11 567 34 722 567 34 17 18 19 751 535 224 433
672 567 65 162 753 719 757 306 179 6 781 535 256 722 567 34 49 50 51 751 567 224 433
644 564 500 501 501 500 501 500 503 161 501 565 226 722 535 34 98 753 719 757 535 288 433
672 35 39 36 802 3 781 780 36 6 36 675 146 722 564 500 501 501 501 501 565 96 433
73 800 772 673 640 35 814 38 66 771 801 72 144 718 401 205 3 780 36 206 132 264 433
147 98 98 71 800 772 35 36 72 72 132 146 435 718 718 265 35 10 4 178 145 401 179
433 145 263 207 269 73 72 274 145 147 274 433 718 177 177 179 6 36 35 4 178 179 3
401 433 433 295 306 275 146 179 178 433 401 307 294 209 71 73 771 801 674 37 4 3 782
433 401 433 147 98 178 179 98 102 306 179 98 103 102 98 103 103 67 640 37 780 10 814
433 401 433 179 105 102 66 103 67 102 66 105 104 67 164 105 67 705 3 812 813 36 35
