3e003f40
26 30
812 813 4 146 401 263 262 147 73 800 770 772 673 676 673 72 3 781 42 10 780 36 535 65 444 407 225 756 752 752
845 10 36 270 176 178 179 178 327 73 72 73 72 71 70 6 36 35 39 40 36 105 567 65 444 436 350 287 350 346
877 36 146 401 179 103 3 4 3 7 4 102 103 102 103 532 538 501 503 161 502 501 565 225 476 381 382 319 383 349
36 146 401 307 103 769 35 10 532 500 501 501 500 501 536 569 97 275 146 147 35 781 38 103 724 784 720 720 720 720
5 178 433 147 71 642 3 42 534 65 35 36 103 3 781 567 129 179 300 294 725 35 36 753 752 752 750 718 718 757
146 275 144 401 147 3 780 36 535 65 153 154 155 780 10 534 34 17 18 19 751 3 4 17 18 19 721 750 757 103
178 401 433 433 271 35 36 71 567 34 185 186 187 35 36 566 225 49 50 51 751 35 36 49 50 51 721 757 103 742
100 144 177 179 178 147 73 672 535 65 103 753 719 720 720 720 147 71 723 70 721 719 725 71 724 719 757 742 655 580
146 179 532 503 161 751 502 536 569 34 281 282 283 721 718 750 752 719 177 719 757 98 721 719 757 103 591 580 616 583
366 367 535 65 274 718 147 71 535 34 313 314 315 721 757 535 193 20 21 24 98 724 757 103 72 774 1 523 544 429
366 367 567 256 718 816 718 275 534 34 754 753 719 757 3 567 65 52 32 56 724 757 103 742 742 743 73 559 424 460
364 365 535 288 179 41 178 722 535 34 217 218 219 723 37 534 97 720 719 720 179 103 591 580 578 616 497 655 491 428
364 365 567 34 3 39 5 751 534 65 249 250 251 751 35 535 129 179 71 756 147 103 559 524 587 513 615 545 583 545
228 229 534 65 20 21 24 751 567 65 753 719 783 179 3 567 34 17 18 19 721 147 73 559 715 523 523 425 586 522
4 103 567 65 52 32 56 751 564 500 501 500 501 500 536 569 34 49 50 51 721 176 206 73 684 559 524 547 578 616
780 4 535 34 753 719 720 718 725 3 7 781 10 10 10 535 34 102 723 70 178 718 179 3 4 73 559 1 588 513
36 9 534 34 71 70 756 718 722 35 36 35 39 780 10 567 65 70 756 719 720 176 6 780 39 5 73 67 715 524
395 102 535 65 17 18 19 721 757 70 17 18 19 35 781 534 65 20 21 24 721 722 102 17 18 19 132 684 685 495
296 205 534 65 49 50 51 751 70 103 49 50 51 103 35 566 225 52 32 56 721 179 71 49 50 51 3 4 73 495
364 365 535 34 71 756 720 722 102 724 719 719 719 719 720 784 147 146 719 720 750 719 754 103 753 3 780 38 132 73
228 365 567 65 3 4 756 752 719 757 102 103 3 4 178 752 752 757 70 178 722 103 3 4 103 35 812 813 4 3
208 265 564 500 501 500 501 500 501 500 501 500 501 503 161 502 536 537 505 161 396 502 500 501 500 501 500 501 500 501
146 401 147 73 72 35 36 35 10 42 39 40 36 72 274 147 73 566 225 41 331 103 3 7 4 70 679 742 742 655
178 177 401 205 17 18 19 70 35 36 17 18 19 146 233 294 145 147 6 42 4 3 780 782 36 105 591 580 578 616
4 236 433 265 49 50 51 146 273 147 49 50 51 144 237 41 300 294 390 11 781 36 35 814 4 73 559 525 587 512
2 4 178 433 147 132 208 307 301 178 263 207 262 179 3 2 4 534 193 35 36 3 4 35 36 684 685 559 715 587
