12001314
22 25
6 169 102 105 171 102 111 38 38 105 171 102 103 130 66 66 172 173 194 224 192 66 66 102 103
38 109 761 731 731 762 66 102 103 131 194 192 70 71 70 79 71 224 192 70 71 140 141 66 67
105 131 89 87 88 853 762 194 192 70 522 427 426 427 460 864 865 866 866 867 866 866 867 868 78
175 761 121 119 120 852 794 195 192 142 554 823 824 825 824 896 897 992 993 992 992 992 899 900 2
175 793 763 660 724 794 195 192 70 6 586 820 821 822 821 869 897 992 993 993 992 993 899 932 2
73 194 192 793 794 130 70 79 522 426 553 820 821 821 822 933 961 962 962 962 962 962 963 964 2
6 71 131 138 78 72 6 522 553 823 824 822 458 820 822 525 462 426 772 417 418 772 426 553 2
38 169 138 522 426 427 426 553 823 821 822 822 458 820 821 459 614 705 804 452 453 804 614 705 34
143 67 136 554 823 825 825 824 822 821 822 456 457 820 822 491 2 3 836 793 794 836 36 35 66
6 137 168 586 820 822 821 821 822 822 456 425 489 820 822 552 521 135 195 192 66 194 224 192 66
38 103 42 554 820 822 821 427 426 427 426 427 521 820 821 824 552 460 461 462 462 462 462 427 521
103 67 136 586 820 821 822 824 825 824 824 825 491 820 822 822 824 824 490 823 33 823 824 824 491
71 98 168 554 820 821 822 822 821 821 822 822 552 521 820 821 821 822 824 822 824 821 33 820 491
6 71 42 586 820 822 821 822 821 822 821 822 824 491 820 822 822 821 458 820 822 822 824 822 491
38 103 136 772 426 427 426 427 772 820 821 822 772 426 427 426 426 427 426 427 426 427 426 427 553
103 67 168 804 614 707 708 705 804 452 454 453 804 614 707 708 707 708 707 708 707 708 707 708 705
71 99 67 836 102 105 194 193 836 452 454 453 838 4 194 193 102 103 224 320 321 193 36 102 38
103 162 67 131 67 131 67 162 67 729 660 730 194 192 194 192 66 67 761 731 762 66 67 67 142
66 99 67 99 67 70 79 71 67 793 692 794 67 67 67 66 66 761 89 87 88 762 66 66 102
73 224 192 131 99 102 6 143 224 192 727 67 70 71 99 98 67 734 121 119 120 730 195 192 67
38 73 70 79 71 70 38 6 71 66 727 67 142 6 79 71 99 793 763 763 764 794 66 67 70
38 38 38 6 6 38 38 6 6 77 727 76 6 38 38 6 79 71 70 79 71 67 70 79 38
