7300cd75
32 32
870 836 837 804 841 870 805 911 839 804 841 870 805 841 568 55 2 55 668 841 870 805 841 839 804 911 870 805 841 839 804 805
839 806 804 805 873 870 837 943 870 836 873 839 837 873 665 55 34 55 700 873 839 837 873 870 836 943 870 837 873 870 836 837
839 804 806 837 841 839 804 904 871 806 841 839 804 841 152 56 636 57 55 841 839 804 911 839 806 904 871 804 841 839 806 804
839 838 805 806 873 870 805 873 872 804 873 870 805 873 184 573 538 574 121 873 870 805 943 839 804 841 872 805 873 839 804 805
870 836 837 804 841 870 837 841 870 836 911 839 837 841 152 573 538 574 55 841 839 837 903 871 836 873 870 837 911 870 836 837
839 806 804 805 841 839 804 873 839 806 943 839 804 873 119 573 538 574 151 873 839 804 873 872 806 841 839 804 943 839 806 804
839 804 806 837 841 870 805 841 839 804 904 871 805 873 813 635 604 603 813 873 870 805 841 839 804 873 870 805 936 871 804 805
839 838 805 806 911 870 837 873 870 836 873 872 837 873 846 309 311 310 845 873 839 837 873 870 836 841 870 837 873 872 836 837
870 836 837 804 943 839 804 905 876 874 908 839 804 841 878 281 281 281 879 911 839 806 841 839 806 905 876 874 908 839 806 804
839 806 804 805 936 871 805 873 966 933 873 870 805 911 319 249 249 249 317 943 839 804 873 839 804 911 966 932 873 839 804 805
839 804 806 837 873 872 837 841 902 901 841 870 837 943 221 249 249 249 317 904 871 836 841 870 836 943 902 900 841 870 836 837
839 838 805 806 873 839 804 873 839 806 873 839 804 936 316 249 249 249 317 873 872 806 873 839 806 904 871 804 873 839 806 804
870 836 837 804 905 876 874 908 839 804 841 870 805 841 319 249 249 249 317 905 876 874 908 839 804 841 872 805 841 839 804 805
839 806 804 805 911 966 932 873 870 836 873 870 837 873 319 249 249 249 317 841 966 932 911 870 836 873 870 837 873 870 836 837
839 804 806 837 943 902 901 841 839 806 841 839 804 841 351 313 313 313 284 841 902 900 943 839 806 841 839 804 841 839 806 804
839 838 805 806 904 871 805 873 839 804 911 839 805 813 844 875 938 868 939 813 839 804 903 871 804 873 870 805 911 839 804 805
870 836 837 804 841 872 837 841 870 836 943 870 837 845 966 841 1002 870 971 845 870 836 841 872 836 841 870 837 943 870 836 837
839 806 804 805 873 839 804 911 839 806 904 871 804 877 901 873 902 936 900 877 871 806 905 876 874 908 839 804 936 871 806 804
839 804 806 837 841 839 805 943 870 804 841 872 805 836 837 841 839 837 804 836 837 804 841 966 932 911 870 805 841 872 804 805
839 838 805 806 873 870 837 936 871 836 813 842 868 939 810 813 843 809 810 938 868 939 813 902 900 943 870 837 873 870 836 837
809 938 868 1003 908 839 804 841 872 806 845 1002 870 971 933 845 966 932 933 970 934 971 845 870 836 904 871 838 841 839 806 804
966 970 935 971 841 870 805 873 839 804 877 900 936 900 900 877 900 900 901 900 904 901 877 871 804 905 876 874 908 839 804 805
902 901 936 900 841 870 837 841 870 836 804 805 806 804 805 806 804 805 806 804 805 806 804 804 806 841 966 933 841 870 836 837
870 836 837 804 911 839 804 905 938 868 939 810 809 874 875 938 868 939 809 810 874 875 938 868 939 813 902 900 911 839 806 804
839 806 804 805 943 839 805 873 1002 934 971 932 933 932 841 1002 934 971 932 933 932 841 1002 870 971 845 839 836 943 839 804 805
839 804 806 837 904 871 837 841 902 936 901 901 901 900 841 902 904 901 900 901 900 873 902 936 901 877 871 805 904 871 836 837
839 838 805 806 841 872 804 873 870 836 806 836 806 837 873 870 836 806 836 806 837 873 870 836 806 836 804 806 873 872 806 804
870 836 837 804 813 843 810 813 843 809 810 938 868 939 813 843 810 809 938 868 939 813 843 938 868 1003 875 876 813 839 804 805
839 806 804 805 845 966 933 845 966 932 933 970 870 971 845 966 933 932 970 870 971 845 966 970 934 971 911 966 845 870 836 837
839 838 806 837 877 900 901 877 900 901 900 900 903 900 877 901 900 900 901 936 900 877 900 900 904 900 943 902 877 871 837 838
839 804 805 806 804 805 806 804 805 806 804 805 806 804 805 806 804 805 806 804 805 806 804 805 806 837 903 871 804 805 806 804
870 836 837 804 836 837 804 836 837 804 836 837 804 836 837 804 836 837 804 836 837 804 836 837 804 836 841 872 806 837 804 836
