2c002d2e
24 30
721 721 721 721 721 721 459 720 721 721 721 721 721 721 721 721 721 721 458 720 721 721 721 721 721 721 721 721 721 459
721 721 721 721 721 721 496 720 721 721 721 721 721 721 721 721 721 721 491 720 721 721 721 721 721 721 721 721 721 491
721 721 721 721 721 721 491 720 721 719 720 721 721 721 721 719 720 721 459 720 721 719 720 721 721 721 721 719 720 458
426 427 427 426 427 426 553 720 721 751 721 721 458 720 721 751 721 721 490 720 721 751 721 721 458 720 721 751 721 459
722 722 722 722 722 722 722 721 721 721 721 721 459 720 721 721 721 721 722 721 721 721 721 721 459 720 721 721 721 491
721 721 721 721 721 721 721 721 721 721 721 721 491 720 721 721 721 721 721 721 721 721 721 721 458 720 721 721 721 458
426 427 521 452 454 453 520 426 427 426 427 426 460 461 427 426 427 427 426 427 427 426 427 426 521 720 721 721 721 459
723 722 459 452 454 453 491 614 611 612 611 612 609 491 614 611 612 611 612 611 612 611 612 609 459 720 721 721 721 459
720 721 459 820 821 822 459 823 824 825 824 824 825 459 823 824 825 824 825 824 825 824 824 825 458 720 721 721 721 458
33 721 491 820 822 822 450 820 33 820 33 820 822 491 820 822 520 426 427 521 820 821 822 822 458 720 721 721 721 458
723 33 459 820 822 822 482 820 824 33 823 33 820 455 820 822 459 787 786 458 820 822 822 822 459 720 721 719 720 459
33 723 459 820 821 821 491 820 822 824 822 824 821 487 820 822 491 784 785 496 820 822 821 822 459 720 721 751 721 458
723 33 491 820 822 821 552 426 427 426 427 426 427 553 820 821 552 427 416 553 820 821 822 821 458 720 721 721 721 491
720 722 491 820 822 821 608 611 612 611 612 611 612 609 820 821 824 825 824 825 821 821 822 821 459 720 721 721 721 458
720 721 458 820 822 822 825 824 825 824 825 824 825 824 822 821 821 822 821 822 821 822 822 520 553 720 721 721 721 459
427 480 426 427 427 883 883 885 427 426 427 426 427 521 822 821 822 822 821 822 822 822 520 484 723 721 721 721 721 484
722 722 722 722 722 915 916 917 723 722 722 722 722 459 520 426 521 821 822 520 426 521 459 679 452 454 454 454 453 679
721 721 721 656 595 596 624 949 595 657 721 721 721 459 459 419 459 822 821 459 419 459 459 743 452 454 454 454 453 743
721 719 720 688 627 688 660 689 627 689 721 719 720 491 552 787 553 820 821 552 787 553 491 823 825 824 825 824 825 824
721 751 721 721 721 688 687 689 721 721 721 751 721 458 773 483 773 820 821 773 483 773 458 820 822 821 822 821 821 822
484 721 721 484 427 427 426 427 426 484 721 721 721 484 806 451 805 820 821 805 451 805 459 820 821 822 821 822 822 821
679 452 453 679 614 609 740 608 609 679 452 454 453 679 823 824 824 822 821 824 825 824 459 820 822 822 821 822 821 822
743 452 453 743 823 825 824 825 824 743 452 454 453 743 820 821 822 821 822 821 822 821 491 820 822 821 822 821 822 821
821 824 825 822 821 822 821 822 821 822 824 825 825 822 821 822 821 822 821 822 821 822 458 820 821 822 821 822 822 821
