2c00d52e
29 32
459 876 842 841 842 841 841 841 184 715 720 842 459 876 915 916 917 876 459 876 721 715 184 842 842 841 841 841 842 841 842 459
491 877 841 1 877 841 1 877 184 839 876 721 491 876 596 624 949 842 491 720 842 839 184 841 842 1 877 842 841 1 877 491
459 877 841 843 841 841 843 841 776 871 721 842 459 876 688 627 689 841 459 876 721 871 776 842 842 843 841 841 841 843 842 459
491 876 841 715 746 746 746 715 184 491 875 721 459 715 721 785 721 715 459 720 842 491 184 715 746 746 746 746 715 875 842 491
459 877 842 839 814 778 778 839 184 459 720 841 491 840 452 454 453 839 491 877 721 459 184 839 814 778 778 778 839 876 841 459
491 877 842 871 843 844 843 871 184 459 877 721 491 872 486 454 453 871 491 720 842 491 184 871 843 844 844 844 871 842 842 459
459 877 841 841 841 841 841 841 184 491 720 841 459 876 722 786 722 842 459 876 721 459 184 842 841 842 841 841 842 841 841 491
748 746 747 746 747 521 875 841 184 459 876 716 685 749 721 785 721 748 718 749 875 459 184 841 842 520 746 747 746 746 746 459
780 778 778 778 778 459 876 842 184 459 720 780 459 781 720 785 721 780 491 782 720 459 184 841 842 459 814 778 778 778 778 491
843 844 843 843 844 491 877 841 184 459 876 722 459 874 721 785 721 843 459 723 842 491 184 842 841 491 874 844 843 843 844 459
842 841 842 841 842 459 876 842 184 459 720 841 459 876 721 785 721 842 459 876 721 459 184 842 841 459 876 842 842 841 841 491
841 842 842 841 841 459 877 841 184 491 877 721 459 876 721 785 721 841 459 720 842 459 184 841 842 459 876 841 842 841 841 459
842 841 491 877 842 491 876 841 184 491 720 841 715 876 1 784 1 876 715 876 721 459 184 842 842 491 876 842 491 877 842 491
841 841 459 876 841 459 877 842 184 459 876 721 839 876 722 785 722 842 839 720 841 459 184 841 841 459 877 841 459 876 842 459
842 842 491 877 841 459 876 841 184 491 720 842 871 842 785 721 785 841 871 842 721 491 184 841 842 459 877 841 491 877 842 491
841 841 459 877 842 491 877 842 184 491 877 721 491 720 841 785 842 721 491 720 841 459 184 842 841 491 877 842 459 876 842 459
841 842 491 877 841 459 876 841 184 484 746 484 746 484 746 484 746 484 746 484 746 484 184 841 842 459 876 841 491 877 842 491
842 841 459 876 842 715 877 842 184 714 148 714 148 714 148 714 148 714 148 714 148 714 216 841 842 715 877 842 459 876 841 459
841 842 459 877 841 839 876 841 184 181 180 181 180 181 180 181 180 181 180 181 180 181 213 841 842 839 876 841 459 876 841 459
842 841 491 876 842 871 842 842 841 842 841 842 841 842 841 184 841 841 842 841 842 842 842 842 842 871 842 842 491 877 842 491
841 842 459 877 841 842 841 842 841 842 841 842 841 842 841 184 842 841 842 841 842 841 842 841 842 841 842 841 491 876 842 491
841 841 745 876 842 842 841 842 841 842 841 842 841 842 841 184 841 841 842 841 842 841 842 841 842 841 842 841 745 877 841 745
842 841 777 876 842 842 842 841 842 841 842 842 842 842 842 184 842 841 842 841 842 842 841 842 841 842 842 842 777 876 841 777
182 744 214 182 182 182 182 182 182 182 182 182 182 182 182 213 182 182 182 182 182 182 182 182 182 182 182 182 182 744 214 182
841 842 841 841 842 841 842 721 721 721 721 721 842 842 841 842 842 841 841 721 721 721 721 721 841 842 842 841 842 841 842 841
842 841 842 715 841 841 842 721 904 905 906 721 842 721 721 721 721 721 842 721 904 905 906 721 842 842 842 715 841 842 842 715
841 841 841 839 876 842 715 721 936 937 938 721 842 721 904 905 906 721 842 721 936 937 938 721 715 841 842 839 876 842 842 839
842 841 842 871 842 841 839 720 968 969 970 721 841 721 936 937 938 721 841 721 968 969 970 721 839 876 842 871 842 841 842 871
841 842 841 842 841 842 871 721 721 721 721 721 841 721 968 969 970 721 841 721 721 721 721 721 871 842 842 841 842 841 842 842
