01000203
10 16
212 276 213 213 213 26 782 848 849 165 164 165 270 402 231 165
212 212 212 213 213 58 165 720 165 204 273 145 433 271 165 165
212 212 212 213 88 20 782 164 165 264 433 433 393 231 782 782
213 213 87 22 163 162 98 165 260 305 295 301 363 268 267 57
86 26 720 98 99 131 132 198 434 199 165 165 204 404 181 190
817 784 785 132 98 99 204 402 305 307 165 720 234 183 190 190
849 165 706 163 132 164 302 297 130 131 165 165 782 29 212 212
769 771 229 165 165 206 234 235 162 163 737 782 165 93 212 212
704 70 82 109 198 434 273 199 165 165 228 676 783 27 212 212
70 6 38 71 270 433 433 433 199 70 71 170 815 720 23 212
