01004c03
21 23
587 544 461 583 419 618 583 424 465 532 605 559 524 456 683 584 422 428 492 553 423 583 746
524 424 460 551 459 464 779 747 592 636 598 782 559 587 545 614 423 551 545 586 747 592 652
555 425 428 480 616 592 685 98 44 2 45 98 899 559 549 419 618 582 426 592 652 653 654
587 454 492 583 780 720 653 98 631 606 535 98 361 679 559 491 492 432 590 684 685 98 98
524 587 545 492 561 98 631 563 821 830 820 630 98 98 685 689 780 687 783 941 942 943 782
559 524 424 551 780 98 599 823 796 766 822 533 535 395 98 720 98 98 815 973 974 975 98
652 559 747 687 98 98 98 599 823 991 534 98 599 34 570 570 630 98 98 1005 1006 1007 98
135 782 685 684 653 98 631 531 895 767 605 685 204 433 209 98 599 535 98 98 230 275 98
932 71 684 685 98 98 599 823 830 822 598 711 236 231 98 98 98 600 98 98 198 401 199
932 46 98 98 78 75 98 636 796 534 720 98 98 98 775 777 98 696 412 569 178 305 403
685 775 776 777 168 137 98 532 824 605 98 98 98 679 749 750 631 827 34 863 630 782 230
776 688 782 74 72 103 631 895 830 829 535 98 98 652 748 592 636 605 46 599 605 98 98
653 720 74 72 103 631 821 822 634 823 605 98 395 98 684 653 532 598 98 98 600 720 98
98 98 106 46 98 636 822 598 98 599 863 630 368 199 685 68 37 69 720 98 636 535 98
98 631 630 98 7 659 598 98 98 198 2 2 435 231 98 631 605 720 98 631 895 534 98
98 599 826 691 39 627 98 198 273 433 2 2 307 98 631 895 534 98 631 821 822 598 98
98 98 659 598 11 98 98 178 295 301 532 606 630 631 821 795 829 630 604 822 598 98 782
631 691 627 98 98 782 98 98 782 98 636 767 767 821 795 795 796 927 959 598 98 98 98
828 598 74 75 98 98 98 98 98 98 636 830 822 635 635 634 635 634 598 98 98 720 98
598 98 142 109 783 208 199 720 98 98 532 822 598 98 98 784 785 98 782 98 98 932 135
98 899 169 98 815 98 292 275 203 98 532 598 98 70 79 135 75 720 98 98 932 111 103
