01000203
15 15
782 173 67 782 106 782 102 807 808 809 705 642 67 782 67
782 782 134 82 79 45 720 839 840 841 640 800 782 67 67
67 44 6 6 81 782 67 871 872 873 800 498 768 467 720
67 720 166 114 6 71 782 67 396 67 67 768 782 800 769
653 67 67 782 168 6 71 720 368 209 720 498 674 706 741
685 684 67 782 720 104 6 71 328 267 67 70 71 782 70
684 685 653 44 43 114 111 103 236 265 782 172 166 79 6
684 653 782 67 720 67 720 782 596 34 630 162 67 102 6
538 570 538 630 35 67 631 570 598 396 599 597 782 67 47
807 808 809 599 570 571 605 720 324 307 67 599 630 720 67
839 840 841 720 67 631 598 298 299 782 67 67 628 538 539
871 872 873 67 596 598 206 720 67 67 720 782 67 67 782
67 396 67 67 2 327 330 67 782 720 67 67 67 783 67
782 368 209 631 598 298 299 140 75 67 784 785 67 815 67
332 333 596 598 74 782 70 6 137 720 67 67 782 67 782
