01000203
10 15
423 583 780 783 130 99 130 99 99 99 599 634 634 634 797
747 592 685 130 99 99 99 99 99 198 273 273 263 269 599
652 653 654 99 99 99 99 208 273 435 433 433 433 433 199
685 130 99 99 162 162 99 162 300 304 232 433 433 433 433
782 99 99 99 99 99 743 99 99 99 234 294 305 403 433
130 99 98 720 742 384 424 497 720 130 99 743 99 230 401
99 99 685 384 424 583 456 492 497 783 384 424 497 783 300
652 653 749 581 456 553 587 512 585 545 583 456 492 497 783
685 752 457 492 833 481 550 587 418 618 461 583 513 585 579
384 609 587 617 615 424 553 524 455 492 429 779 587 578 608
