01000203
30 20
213 213 213 213 277 212 276 213 213 213 213 213 213 213 213 213 214 401 501 720
213 213 213 213 245 212 212 212 213 214 215 283 283 213 213 280 401 503 784 785
213 213 213 213 213 212 212 212 280 433 401 401 401 215 315 214 433 506 720 723
213 315 315 213 213 213 213 283 214 433 433 433 433 401 433 401 433 231 912 755
280 433 433 215 315 283 214 433 433 401 295 294 305 403 433 233 301 880 913 914
213 246 433 433 433 433 433 433 433 231 165 165 165 300 304 235 684 912 721 722
213 214 433 433 433 433 433 433 231 165 165 720 783 165 165 165 684 944 753 754
280 433 433 433 433 433 433 433 205 720 783 880 786 783 163 164 99 66 912 711
245 246 247 313 246 433 247 246 265 163 784 786 721 722 882 783 98 679 723 882
213 245 212 212 212 313 212 280 433 199 783 680 753 754 914 815 130 711 755 914
213 213 213 212 213 283 315 214 433 231 591 424 649 786 946 163 164 130 721 722
213 213 212 212 280 433 433 433 231 655 523 425 528 783 99 164 98 679 753 754
213 213 213 213 214 433 433 231 493 549 416 618 560 66 98 98 384 544 618 492
213 213 213 213 246 433 271 98 463 524 459 528 849 98 130 493 524 424 429 429
213 213 213 277 214 433 271 98 463 419 618 560 163 99 98 463 417 618 429 560
213 213 245 280 433 433 271 98 495 456 429 649 745 131 98 559 491 429 465 849
213 277 245 212 246 433 271 98 495 587 545 496 679 165 165 99 495 513 492 561
277 245 245 212 280 433 433 263 689 524 491 429 718 165 165 131 430 587 545 496
277 244 213 212 212 246 433 433 199 559 587 544 528 720 98 98 559 524 456 429
213 213 315 245 212 245 246 433 271 98 430 459 496 783 98 165 165 495 587 545
213 280 433 215 213 245 280 433 231 98 559 459 560 815 720 165 165 559 524 459
213 214 433 433 314 277 214 231 880 881 786 751 723 785 66 99 98 752 418 618
280 433 433 433 215 214 297 784 786 786 786 786 914 782 98 131 384 524 459 429
213 246 433 433 433 433 265 815 944 786 786 786 946 66 165 98 430 451 491 429
213 280 433 433 433 433 433 199 98 944 945 946 783 165 165 626 524 491 550 513
245 214 433 433 433 233 294 295 98 98 98 720 815 98 99 679 559 524 545 614
213 246 433 433 433 237 749 625 680 745 130 98 99 163 164 98 66 559 549 419
213 214 433 433 231 591 459 613 616 497 684 98 131 165 165 98 395 679 559 491
280 433 433 231 591 608 549 418 717 429 593 684 165 98 165 204 369 98 685 689
214 433 231 626 612 422 583 459 615 544 718 784 785 130 164 264 401 199 98 720
