66006768
32 23
880 880 880 880 880 880 787 6 372 943 880 880 881 783 504 783 409 847 815 816 720 504 783
880 880 880 880 880 880 976 407 374 975 880 880 819 535 502 783 404 879 938 939 940 503 534
975 775 776 777 975 819 6 404 943 847 880 880 784 504 783 535 502 785 970 971 972 785 372
785 807 808 809 114 815 816 536 975 880 880 880 535 502 847 503 534 817 1002 1003 1004 817 404
817 839 840 841 130 102 535 502 6 975 880 976 536 943 880 944 503 534 535 34 534 535 502
103 130 331 130 130 535 502 784 103 102 975 535 502 975 975 976 783 503 502 331 503 543 6
71 943 944 834 130 504 785 943 944 70 783 372 6 783 103 110 110 47 70 71 783 503 534
103 975 976 641 784 377 817 975 976 102 784 409 783 103 130 943 723 944 102 775 776 777 503
162 672 706 801 535 373 815 816 801 864 102 2 390 130 847 879 880 881 130 807 808 809 722
944 130 855 856 504 943 944 784 990 990 784 536 943 848 880 880 880 881 783 839 840 841 720
976 784 130 174 506 975 976 70 943 944 535 502 879 880 880 818 975 976 103 783 331 722 723
674 801 926 70 377 785 815 816 975 976 536 783 975 976 976 6 784 103 70 815 816 879 880
849 990 783 407 374 817 102 943 785 944 503 534 943 944 130 102 103 130 784 70 943 847 880
976 136 535 373 784 865 926 879 880 881 785 536 975 976 130 943 944 815 816 102 975 880 880
535 508 502 816 801 224 784 975 912 976 817 503 534 110 130 975 976 102 103 943 848 880 880
502 943 943 944 990 784 943 944 6 640 783 102 503 534 785 130 815 816 130 975 880 880 880
786 847 847 880 849 70 975 976 642 783 70 943 944 504 817 130 672 783 784 102 975 912 912
751 880 880 880 881 944 783 804 943 848 849 975 976 372 783 641 642 192 103 783 535 508 509
944 975 880 880 880 881 113 331 879 880 880 849 407 374 943 944 944 784 82 407 502 943 944
976 130 975 976 912 976 395 783 879 880 880 881 404 943 847 880 976 535 34 374 784 975 976
130 943 944 783 804 208 293 783 975 976 879 881 372 975 880 881 500 502 81 784 785 706 865
783 975 976 784 396 783 943 944 865 800 975 976 404 783 975 976 372 786 944 102 817 769 798
672 801 864 804 293 131 975 976 990 990 672 677 503 534 350 535 373 775 776 777 102 785 771
534 73 990 672 395 98 66 67 804 785 784 815 784 503 447 502 672 807 808 809 130 817 801
503 376 534 73 366 367 801 864 361 817 740 405 342 500 502 815 816 839 840 841 130 113 966
785 166 503 509 34 534 990 990 784 47 346 415 414 447 501 346 342 783 331 783 70 785 769
817 134 783 642 331 503 376 534 71 783 378 414 447 447 382 415 411 815 816 113 783 817 803
641 642 71 134 135 784 102 372 103 47 437 447 447 442 343 439 474 475 472 943 944 865 993
70 82 6 6 167 133 132 404 943 944 70 541 447 468 815 816 437 382 342 975 976 990 944
6 6 6 169 943 943 944 506 975 976 784 372 443 447 468 350 410 415 411 847 944 847 880
6 38 38 109 879 848 881 503 534 783 535 373 783 511 443 444 412 411 943 880 880 880 880
38 6 143 783 818 912 976 6 504 47 504 943 944 943 848 848 848 848 847 880 880 880 880
