5b005c5d
21 19
981 950 950 950 981 950 1014 251 283 284 285 286 254 950 950 1014 950 950 1014
1013 950 950 950 950 1014 282 283 316 358 358 318 286 287 950 1014 1013 1014 251
981 1013 949 950 1014 1013 314 570 317 317 317 317 318 319 1014 982 949 251 283
403 1014 981 950 950 218 639 602 317 317 317 317 446 312 219 1013 282 283 316
442 982 950 950 950 222 474 508 542 506 507 542 506 475 223 982 314 315 317
441 982 1013 950 950 191 476 540 571 538 539 571 541 477 190 949 249 347 349
253 254 981 982 950 191 639 509 574 317 317 573 478 390 359 359 391 445 360
285 286 254 981 982 218 607 510 349 349 355 414 349 280 219 1013 313 347 354
317 318 286 287 1014 218 639 543 317 317 387 413 317 312 219 949 281 347 354
349 388 318 319 1013 1014 575 543 388 349 317 349 349 280 949 949 249 347 384
317 388 349 390 359 359 391 543 360 360 360 360 605 390 359 359 391 445 388
349 317 317 390 359 359 391 543 382 352 355 415 349 280 950 983 639 347 349
360 360 605 280 950 1014 281 360 412 384 387 413 386 280 950 982 410 389 381
355 415 317 312 950 1013 246 360 360 412 358 360 360 247 950 949 281 347 382
387 413 317 351 950 982 278 308 309 392 392 340 341 279 950 1014 246 572 348
380 379 389 383 950 949 218 372 373 392 392 402 377 219 1014 981 278 307 309
352 352 479 280 950 982 222 404 405 392 392 443 409 223 981 950 218 372 373
384 384 317 312 950 982 191 186 250 392 392 255 187 190 1013 950 222 404 405
348 348 348 247 1014 949 191 185 283 393 393 447 184 190 949 1014 191 186 437
340 275 339 279 949 949 217 283 316 382 382 318 286 216 981 982 191 220 189
376 376 377 219 949 949 314 315 388 317 317 388 318 319 951 949 218 220 1013
