0a003a0c
12 17
720 721 721 459 820 822 822 822 822 490 820 822 822 459 720 721 721
720 721 721 496 820 822 821 822 821 824 821 822 821 496 720 721 721
720 721 721 459 820 821 822 821 822 459 820 821 822 459 720 721 721
426 448 428 426 426 426 448 428 460 461 426 448 492 461 426 448 428
722 722 722 722 722 722 722 722 722 459 823 824 825 459 723 722 722
721 721 721 721 721 721 719 720 721 459 820 33 820 496 720 719 720
484 720 484 432 720 721 751 721 721 459 820 824 822 459 720 751 721
679 451 679 459 720 484 430 426 426 484 430 448 428 484 720 721 721
711 451 711 459 483 679 585 739 704 679 806 420 805 679 452 454 453
130 729 762 459 720 547 722 722 722 547 722 722 722 547 722 722 722
756 724 730 459 720 721 721 719 720 721 721 719 720 721 721 719 720
724 724 790 459 720 721 721 751 721 721 721 751 721 721 721 751 721
