0a003a0c
18 15
453 718 426 426 426 426 426 427 426 426 426 460 461 427 426
453 491 723 722 722 722 722 722 722 722 722 722 491 614 611
824 491 720 785 721 785 721 721 785 721 785 721 491 823 824
822 491 720 721 719 720 721 721 721 719 720 721 491 820 822
822 491 720 785 751 754 721 721 785 751 754 721 491 820 822
821 491 720 721 721 721 721 721 721 721 721 721 491 820 822
821 552 426 427 426 427 426 484 720 721 484 433 553 820 821
821 608 611 612 611 612 611 742 452 453 742 614 609 820 821
822 825 824 825 824 825 824 826 824 822 826 821 822 821 822
883 883 885 427 426 427 426 427 521 820 821 822 821 822 821
915 916 917 723 722 722 722 722 459 431 902 521 820 821 933
596 624 949 595 657 721 721 721 459 463 419 459 820 822 459
688 660 689 627 689 721 719 720 491 430 787 553 820 821 552
688 687 689 721 721 721 751 859 458 773 483 773 820 822 773
427 426 427 426 484 720 721 721 484 806 451 805 820 821 805
609 805 608 609 679 452 454 453 679 823 825 824 821 822 825
824 825 824 825 743 452 454 453 743 820 822 821 822 821 822
821 822 821 822 825 824 825 824 825 822 821 822 821 822 821
