0a003a0c
10 15
822 459 820 822 822 520 426 883 426 426 883 426 426 883 426
821 459 820 822 821 459 723 881 723 722 881 723 722 881 723
460 493 820 822 822 459 720 721 721 656 595 595 595 595 595
822 459 820 822 822 459 720 719 720 596 625 656 595 595 595
822 459 820 822 822 459 720 751 721 596 625 596 625 625 625
822 490 820 822 822 459 720 721 721 596 625 688 627 627 627
821 824 821 822 821 496 720 721 721 688 627 627 627 627 627
822 459 820 821 822 459 720 721 721 721 721 721 721 721 721
460 461 426 448 492 461 426 448 460 461 426 426 426 426 426
722 459 823 824 825 459 723 722 722 459 585 739 704 705 739
