6c00a36e
24 20
772 772 772 816 810 815 772 773 870 871 871 871 871 776 774 777 870 871 871 871
774 774 774 907 372 907 779 694 974 911 911 911 911 372 871 373 974 911 911 566
871 871 907 970 974 970 907 398 943 1007 804 805 943 911 911 911 1006 1007 1006 567
911 911 970 974 1007 911 970 974 1007 900 694 774 694 774 694 901 943 1006 1007 567
906 1007 911 1007 33 943 911 1007 1007 693 398 871 400 871 400 776 905 943 905 779
1007 1007 907 943 911 1007 905 663 903 777 974 911 911 911 911 372 937 943 937 870
809 903 694 907 943 907 970 398 814 373 943 1006 1007 1006 1007 911 914 945 914 881
807 814 400 970 907 970 974 911 911 911 1007 1007 907 943 907 779 901 943 900 774
807 974 911 911 970 974 1006 1007 1006 1007 900 907 970 943 970 907 695 943 807 372
807 943 1006 1007 911 1007 1007 1006 1007 1007 693 970 974 1007 911 970 807 943 807 372
695 943 1006 1006 1007 1007 900 810 694 662 777 974 1007 33 943 911 807 943 693 974
807 943 1007 774 691 809 875 372 400 871 373 907 943 911 1007 907 807 943 804 805
695 943 1007 372 400 905 373 974 911 911 911 970 907 943 907 970 695 943 804 805
905 943 1007 911 911 937 974 1007 1007 1007 1007 911 970 943 970 900 875 943 776 901
937 943 1007 907 1007 914 945 1007 1007 1007 1007 1007 911 1007 911 806 373 943 372 806
914 945 1007 900 810 774 774 694 774 774 774 901 943 1007 906 806 974 1007 911 806
1007 1007 900 875 372 871 871 400 871 871 871 776 774 662 725 805 943 1007 1007 693
1007 804 805 373 974 911 911 911 911 911 911 372 871 871 804 805 943 1007 1007 806
1007 776 777 974 1007 1007 804 772 805 943 1007 911 911 911 804 805 907 943 907 778
1007 372 373 943 804 772 726 774 774 905 943 1006 1006 774 694 907 970 943 970 907
1007 911 911 1007 804 772 805 372 871 937 943 1007 1007 372 400 970 974 1007 911 970
1007 1006 1006 1007 804 772 805 906 911 914 945 1007 1007 911 911 911 1007 33 943 911
1006 1007 1007 1007 776 774 774 774 901 943 1007 900 662 774 774 907 943 911 1007 907
1007 1007 1007 1007 372 871 871 871 776 774 774 777 870 871 871 970 907 943 907 970
