6c00a36e
27 21
726 774 774 774 774 774 808 809 810 774 774 774 774 774 808 809 810 774 774 774 774
837 974 911 911 911 911 911 806 974 911 911 911 911 911 911 838 974 911 911 911 566
837 943 939 943 939 943 1006 904 943 1006 906 1006 906 1006 1006 911 1006 1006 1006 1006 567
837 943 971 975 971 975 1006 806 943 1006 1006 1006 1006 1006 1006 806 943 1006 1007 1006 567
837 943 1006 1007 1006 1006 1006 776 808 841 943 806 943 900 810 774 774 903 774 774 725
726 810 943 872 841 943 1006 911 911 806 999 806 999 806 974 911 911 911 911 911 804
837 974 1006 911 806 943 1006 1006 1006 806 436 905 436 806 943 1006 1006 1006 1007 1006 804
837 943 1006 1006 804 726 810 808 808 905 468 937 468 905 779 875 921 872 841 943 804
837 943 1006 1006 804 837 870 871 871 937 500 407 469 937 870 373 999 372 806 943 804
726 810 943 776 725 837 436 437 438 407 469 469 469 407 437 438 437 438 806 943 804
837 974 1006 911 804 837 468 469 469 469 469 939 468 469 469 469 469 469 806 943 804
837 943 939 943 804 837 500 469 939 468 501 375 501 501 939 500 469 900 875 943 804
837 943 971 975 804 837 500 501 375 470 469 469 469 470 375 469 469 806 974 1006 804
837 943 1006 1006 804 837 500 470 469 469 501 939 468 470 469 469 900 875 943 1006 804
726 810 943 776 725 837 468 470 939 468 470 375 469 469 939 500 806 974 1007 1006 804
837 974 1006 911 804 837 500 469 375 501 470 469 469 501 375 469 806 943 1006 804 773
837 943 1006 1006 804 837 468 501 469 469 469 939 468 469 469 469 806 943 1006 804 773
837 943 1006 1006 804 837 500 470 939 468 501 375 470 501 939 500 776 901 943 804 773
726 810 943 776 725 837 468 469 375 469 470 469 469 470 375 469 372 806 943 872 725
837 974 1006 911 804 837 500 501 470 470 501 501 469 470 470 470 438 806 943 911 804
837 943 939 943 804 837 468 470 470 470 501 501 501 470 470 470 469 806 943 1006 804
837 943 971 975 804 837 500 470 470 470 470 470 470 900 810 808 808 777 943 1006 804
837 943 1006 1006 804 773 773 773 773 837 500 470 470 806 974 911 911 911 1006 1007 804
726 905 943 905 779 774 774 774 774 808 809 810 808 841 943 1006 1006 1006 1007 1006 804
837 970 999 970 870 871 871 871 871 871 806 870 871 776 808 905 943 905 779 774 725
837 208 202 211 911 911 911 911 911 911 806 974 911 870 871 970 999 970 870 871 804
837 240 242 243 1006 1007 1006 1007 1006 1006 806 943 1006 911 911 201 202 211 911 911 804
