6c00a36e
18 20
98 99 70 6 6 6 6 6 38 38 169 130 131 98 67 198 820 901 948 99
229 66 102 38 38 38 38 38 105 110 107 164 162 130 99 164 162 820 901 948
197 198 164 102 111 103 900 774 774 905 779 905 779 774 901 948 131 64 820 901
769 738 900 789 885 788 907 984 967 937 968 937 968 871 907 980 163 163 64 839
164 900 853 1012 164 98 535 974 65 1001 65 1001 65 911 532 1012 70 71 100 839
774 853 1012 98 98 98 567 65 474 442 162 162 162 64 564 130 142 103 197 839
911 64 99 99 1007 100 567 162 65 905 948 905 943 130 564 162 46 198 229 807
64 442 99 443 65 900 774 905 948 937 1012 937 942 905 779 901 948 163 100 839
71 99 229 65 900 777 1017 937 943 1001 162 1001 65 937 918 776 901 948 98 839
111 45 98 900 777 1017 405 969 964 997 997 965 966 969 870 949 905 779 774 905
905 948 905 839 1017 405 974 888 475 164 164 506 1007 888 911 372 937 918 981 937
937 999 937 839 405 974 444 65 1007 1007 164 65 1007 1007 65 911 920 870 871 920
888 911 888 852 901 942 65 1007 64 64 164 1007 65 442 443 1007 535 870 871 920
65 506 507 949 776 901 948 65 410 164 1007 1006 1007 162 1006 1007 567 911 911 535
100 65 1006 911 949 905 779 774 774 774 905 943 65 444 1007 1007 567 1007 1006 567
1007 1007 1007 1007 911 937 918 981 981 981 937 943 1007 1006 65 1007 567 1006 1007 567
1007 507 65 410 1006 535 870 871 871 871 920 942 442 65 474 1007 907 779 774 905
1006 65 1006 1006 1006 567 911 911 911 911 888 65 474 1006 506 1007 807 918 981 937
