01020304
22 20
428 492 553 587 578 617 460 494 592 903 904 905 720 559 525 580 545 583 523 617
460 615 513 583 587 545 496 720 782 935 936 937 100 65 559 525 491 553 555 617
586 417 646 615 524 459 496 836 720 967 968 969 70 71 65 559 524 580 556 617
779 424 592 559 715 746 592 238 99 208 176 174 6 103 100 65 559 715 587 522
932 751 782 163 720 782 720 100 720 720 144 199 46 720 70 80 782 65 559 746
99 66 163 720 66 720 66 720 66 782 230 177 209 70 6 81 141 720 163 65
70 720 71 163 163 784 785 66 782 99 720 742 742 102 114 114 6 82 71 70
102 6 103 70 720 77 66 782 720 742 591 579 617 529 742 742 102 114 932 113
82 38 82 6 6 782 720 742 591 459 583 587 544 551 459 618 719 932 113 103
113 6 103 46 102 137 655 459 583 616 553 523 422 582 424 592 685 70 38 71
6 38 82 71 70 103 430 459 429 716 494 583 424 494 590 720 163 102 6 38
103 102 103 102 38 45 495 616 496 684 778 779 589 684 685 70 71 70 38 114
71 947 948 949 47 655 417 717 592 67 684 653 654 685 44 6 103 102 103 100
81 979 980 981 163 430 616 528 100 99 163 14 99 70 82 38 82 71 70 71
103 1011 1012 1013 66 463 545 496 685 70 82 6 45 113 38 167 46 166 38 38
71 70 82 82 45 559 896 592 720 113 6 6 137 102 114 45 784 785 102 114
102 38 6 38 71 65 928 163 70 6 6 114 103 67 163 720 816 817 684 686
932 102 111 6 143 66 960 66 102 38 103 163 67 99 816 817 848 849 591 522
561 742 742 102 103 591 992 561 163 46 131 67 99 162 848 849 720 591 524 424
615 555 521 561 591 555 616 465 804 99 163 99 131 163 720 686 591 524 523 616
524 587 422 551 524 619 512 492 529 782 99 804 804 720 591 424 583 417 646 428
523 523 616 582 524 587 556 578 617 529 685 684 685 591 524 522 615 616 428 428
