01020304
16 28
103 100 102 111 103 495 424 615 522 903 904 905 579 617 428 583 417 646 428 583 580 521 428 492 494 560 720 198
163 857 858 859 66 559 491 583 522 935 936 937 619 425 428 615 424 492 428 615 524 616 492 496 784 785 132 230
100 889 890 891 76 71 495 578 616 967 968 969 451 423 460 583 746 615 579 417 646 492 429 592 720 198 205 204
131 921 922 923 174 143 559 587 617 428 429 583 549 616 494 592 684 559 524 616 428 460 592 130 198 401 265 264
135 141 100 140 72 6 71 495 522 460 428 613 417 496 685 684 685 591 555 578 617 528 66 100 230 401 401 401
6 6 82 6 6 38 143 559 746 494 592 559 746 592 684 684 685 495 587 556 544 496 100 130 198 433 307 230
38 6 38 6 38 103 102 77 684 653 654 685 70 43 43 71 684 559 524 587 422 496 66 198 176 238 66 720
6 38 6 114 81 720 174 73 141 684 685 44 103 685 685 46 100 685 559 715 746 592 100 230 176 100 674 133
38 6 103 100 102 71 78 102 6 79 43 43 45 684 684 685 100 684 711 782 64 100 720 332 333 100 642 100
103 102 45 206 76 38 114 82 38 103 685 684 685 100 685 100 100 131 720 66 206 163 99 208 231 99 672 677
782 163 198 231 108 103 206 168 103 684 685 686 653 654 686 685 163 100 100 198 401 199 198 471 100 198 205 99
71 720 144 145 199 198 401 209 720 685 591 424 561 591 424 561 685 684 685 230 401 177 177 436 473 401 241 100
81 100 230 401 176 230 176 782 685 591 524 424 551 555 616 465 684 720 132 66 230 199 67 144 401 403 265 720
6 45 208 433 433 145 231 742 591 524 523 616 582 587 512 492 529 742 686 685 100 144 145 401 176 230 231 100
38 135 141 306 433 231 591 522 583 417 646 428 460 583 587 578 617 613 424 561 782 230 231 230 176 163 816 817
6 38 6 71 238 591 524 522 615 616 428 428 492 551 524 587 425 582 424 428 529 782 720 198 231 720 848 849
