a500a6a7
29 28
427 586 525 424 615 451 427 460 592 821 780 596 598 559 524 587 578 514 576 497 655 616 460 460 593 387 655 616
427 496 559 589 559 715 746 592 631 597 631 598 67 886 559 525 587 588 556 578 616 460 429 592 894 591 424 429
746 592 827 820 881 829 827 631 598 628 598 718 99 854 355 559 715 524 587 556 617 460 592 821 854 559 746 592
355 819 836 66 900 99 780 600 780 70 71 67 132 886 828 355 355 559 525 587 522 496 821 132 946 945 946 355
945 260 261 260 327 324 390 2 130 166 6 71 70 71 66 886 387 355 559 524 424 496 977 66 861 689 862 946
198 293 292 293 397 365 718 600 781 108 103 102 103 104 71 67 66 886 355 559 746 592 945 890 774 513 497 853
231 989 978 977 364 365 631 598 813 99 98 70 71 70 6 804 99 67 822 828 828 819 130 130 886 559 545 497
857 355 355 945 334 335 600 780 131 66 76 6 804 6 38 6 71 132 130 99 132 198 199 66 854 655 616 496
978 355 387 977 234 326 2 208 199 98 70 38 38 6 38 6 103 99 100 198 145 177 231 854 655 616 429 592
355 355 355 387 977 631 598 66 230 199 102 103 46 102 103 46 130 131 132 144 231 66 918 591 424 429 592 355
387 387 387 355 945 599 630 132 132 144 209 132 132 100 132 130 198 145 199 144 199 99 954 559 746 592 885 882
946 945 946 387 858 718 600 781 208 401 145 199 198 145 199 198 177 231 230 401 231 130 950 355 387 819 132 978
718 66 162 957 132 631 598 813 989 238 144 433 177 231 230 231 66 98 132 230 145 199 67 946 945 67 978 355
597 718 780 631 597 601 781 914 355 858 230 176 132 130 131 99 70 71 67 66 238 230 209 67 98 98 946 387
628 539 539 598 628 598 813 882 355 977 99 238 99 100 70 804 113 804 71 804 70 71 132 99 130 130 131 946
780 782 783 718 99 780 162 978 387 945 70 71 70 804 6 38 103 110 102 103 102 804 141 108 71 70 71 131
860 977 978 977 989 132 66 946 945 70 114 6 6 103 102 103 99 98 132 66 131 166 80 130 102 6 103 978
945 946 894 355 355 851 98 70 804 103 67 102 804 80 164 99 807 808 809 132 66 70 804 71 70 103 98 946
782 783 163 822 828 819 98 102 6 71 99 70 103 164 164 132 839 840 841 67 131 102 114 38 6 73 70 71
630 596 630 718 98 130 132 132 168 6 71 102 804 67 130 66 871 872 873 67 131 132 804 113 103 102 6 6
599 629 599 630 164 99 99 99 136 38 103 70 81 99 130 132 102 82 103 99 66 70 81 46 131 70 38 6
718 100 718 601 718 99 66 70 804 103 67 102 804 71 98 132 70 6 71 67 70 6 804 132 66 102 114 6
52 119 67 2 98 99 99 102 6 135 99 98 168 103 132 66 102 6 81 98 102 38 103 66 98 132 136 38
244 26 98 600 781 99 66 99 102 6 175 66 136 804 71 67 70 6 6 71 70 804 164 67 130 76 38 103
245 54 130 600 813 132 132 130 70 103 66 99 102 103 113 804 6 6 6 804 6 38 77 132 67 70 81 141
87 22 67 2 163 164 99 100 102 135 67 132 98 132 102 103 102 38 105 102 103 46 98 132 76 38 38 38
978 977 99 601 718 131 98 132 70 6 71 70 71 98 132 98 70 38 80 98 132 98 66 66 98 102 38 103
387 923 718 599 630 782 783 130 102 38 6 6 6 77 74 70 38 6 137 70 79 71 164 70 71 70 38 71
387 387 977 718 599 570 630 718 132 102 103 102 6 137 70 38 6 38 38 38 103 102 82 6 38 6 38 143
