6c006d6e
20 23
212 92 66 67 799 99 832 926 833 834 835 799 171 704 640 198 168 6 6 38 6 38 77
212 212 58 640 799 832 955 990 865 866 867 799 675 67 676 99 139 113 38 6 167 110 107
212 212 28 768 829 798 986 990 897 898 899 799 641 70 71 676 730 996 997 998 761 738 116
245 212 60 170 740 799 986 988 956 957 797 830 673 113 6 45 67 112 38 6 71 59 212
213 245 92 99 197 730 996 997 997 998 761 673 70 6 167 99 99 102 114 167 173 23 212
213 213 245 56 99 198 986 988 988 990 99 70 38 80 197 55 56 118 99 99 99 59 244
213 213 213 212 54 99 1018 862 988 988 958 102 114 103 57 244 277 88 58 119 57 212 213
213 213 213 213 245 58 730 986 988 990 761 118 100 162 125 212 220 55 212 244 245 212 213
213 213 308 84 86 89 189 34 34 34 190 88 54 53 212 87 88 244 212 213 213 213 213
213 277 797 765 765 765 798 986 988 990 762 798 25 212 24 99 192 125 245 276 213 213 213
213 20 799 833 834 835 799 986 988 988 927 829 729 124 762 765 765 765 798 309 213 213 213
213 54 799 865 866 867 799 892 989 988 988 956 925 2 925 956 988 793 794 796 212 213 213
213 124 799 897 898 899 762 765 729 953 989 1022 55 24 229 986 988 825 826 827 831 276 213
213 212 829 798 955 956 956 956 956 990 138 138 2 74 987 988 988 857 858 859 799 125 213
213 212 54 799 1018 988 988 990 864 928 229 55 220 106 173 1018 989 989 989 1022 799 25 213
213 212 124 829 798 985 990 797 765 765 729 21 124 99 960 197 198 960 197 797 830 57 212
213 212 220 170 730 955 991 761 171 119 99 55 212 54 762 765 765 765 765 830 53 341 212
213 245 212 52 55 723 724 54 55 220 55 244 212 220 99 99 55 58 119 59 212 87 276
213 213 245 212 244 213 213 245 212 212 244 213 213 245 58 53 212 212 212 212 26 960 23
213 213 213 213 213 213 213 213 213 213 213 213 213 213 245 244 213 213 245 245 54 119 57
