6c00a36e
26 25
772 772 772 805 964 965 966 807 471 439 471 471 440 807 943 804 772 772 772 726 810 774 774 774 725
772 772 772 805 974 911 911 838 471 440 440 439 471 838 943 776 774 774 774 777 974 911 911 911 836
772 772 772 805 943 1006 1006 911 2 2 2 2 2 911 1006 911 911 911 911 911 1006 1006 906 1006 836
772 772 772 837 943 1006 1006 805 439 440 440 471 471 776 774 901 943 1006 1006 807 943 1007 1006 1006 836
772 772 772 726 810 943 776 805 471 440 439 471 440 379 378 804 805 943 804 805 943 1006 1006 1006 836
774 774 774 777 974 1006 911 774 774 774 774 774 774 901 471 900 777 943 776 774 901 943 804 772 772
911 911 911 911 1006 1007 1006 911 911 911 911 911 911 807 440 807 974 1006 911 911 807 943 804 772 772
774 774 774 774 774 774 774 774 774 774 774 901 943 807 471 807 942 1006 1006 1007 807 943 776 774 725
378 378 378 379 378 379 378 378 379 378 379 807 943 807 440 807 943 1006 1007 1006 807 943 911 911 804
471 900 810 774 774 774 774 901 471 471 440 776 774 777 440 807 942 1007 1006 1006 836 805 943 1006 836
440 807 974 911 911 911 911 807 471 439 440 379 378 347 471 807 943 1006 1007 1007 836 805 943 1006 836
471 807 943 906 1006 1 943 807 440 440 471 900 810 725 772 805 943 1006 1006 1006 836 805 943 1006 836
439 807 943 1006 1006 911 1006 807 439 440 471 807 974 836 772 772 772 772 772 772 726 777 943 1006 776
440 905 779 943 776 774 774 905 471 900 810 777 943 776 774 774 774 774 774 774 777 974 1006 1006 565
471 937 918 999 949 981 981 937 440 807 974 911 1006 911 911 911 911 911 911 911 911 1006 1006 1007 564
440 970 248 999 248 281 281 970 471 838 943 774 774 774 774 774 774 774 774 774 774 774 774 774 774
471 472 439 34 471 440 439 472 471 347 34 378 378 379 378 378 378 379 378 379 378 378 379 378 379
774 774 777 943 779 774 774 774 774 774 943 774 774 808 774 774 774 774 774 774 774 774 774 774 774
911 911 911 1006 911 911 911 911 911 911 1006 911 911 911 911 911 911 911 911 911 911 911 911 911 911
774 774 774 943 774 774 774 901 943 1006 1006 804 772 772 805 942 1007 1006 1006 1007 1006 1006 1006 776 725
378 379 378 34 378 378 378 776 774 774 774 774 774 725 805 943 1006 1006 1007 1006 1007 1006 1006 911 804
440 900 810 943 774 901 439 378 378 378 378 379 378 804 772 772 772 772 772 772 805 943 1006 1006 804
471 807 974 1006 911 776 774 774 774 774 440 471 471 776 774 774 774 774 774 774 777 943 1006 1007 804
440 807 942 1007 1006 911 911 911 911 911 2 2 2 911 911 911 911 911 911 911 911 1006 1007 1006 804
471 807 943 1006 1007 1006 1006 1006 1006 807 440 439 471 804 772 772 772 772 772 772 805 943 1006 1006 804
440 804 772 772 772 772 772 772 772 805 471 440 471 804 772 772 772 772 772 772 837 964 965 966 804
