6c00a36e
28 20
810 774 808 841 942 1007 842 810 774 774 774 774 774 774 808 809 810 774 808 725
974 911 911 807 943 1007 807 974 906 911 911 911 911 911 911 904 974 911 911 804
942 33 942 904 942 1007 807 942 1007 1007 1006 842 810 774 808 841 942 1006 1006 836
942 911 1007 807 943 1007 807 942 1007 1006 1007 807 974 911 911 807 942 33 942 804
943 1007 1007 807 943 1007 807 942 1007 1007 1007 807 942 906 1007 904 942 911 1007 836
942 1007 1007 807 942 1007 872 841 942 1007 842 777 942 1007 1007 807 942 1006 1007 804
942 1007 1007 807 964 966 870 905 878 879 905 373 964 965 966 807 942 1006 1007 836
774 921 774 777 974 911 911 937 964 966 937 974 911 911 911 807 942 1007 1007 804
404 999 372 373 942 1006 1007 914 881 911 914 945 1007 1006 1007 776 774 921 808 725
911 911 911 911 1007 1006 1007 1007 1007 1006 1007 1007 1007 1007 1007 372 373 999 372 836
1006 1007 1007 1007 1006 1007 842 810 903 808 841 942 1007 1006 1007 911 911 911 911 836
907 905 942 1007 905 907 778 974 911 911 807 943 1007 1007 1007 1006 1007 1007 1007 776
970 937 942 1007 937 970 778 942 1007 1007 807 942 1007 842 810 774 808 841 942 372
1003 914 945 1007 914 914 807 964 965 966 807 943 1007 807 974 911 911 807 943 911
1007 1007 1007 1007 1007 1007 807 974 911 911 807 943 1007 807 942 1006 1007 904 942 804
774 903 808 841 942 1007 905 779 774 774 905 942 1007 807 942 33 942 807 942 804
974 911 911 807 964 966 937 870 871 871 937 964 966 807 942 911 1007 807 999 804
942 1007 1007 807 974 911 914 881 911 911 914 881 911 807 964 965 966 807 942 905
942 1007 1006 807 942 1007 1006 64 506 1007 65 443 1007 807 974 911 911 807 943 937
943 1007 1007 776 774 907 942 905 910 64 907 948 1007 807 942 1007 1007 807 943 888
942 1006 1007 911 911 807 942 937 980 100 937 943 1007 905 779 774 774 905 942 907
942 1007 1007 1006 1007 807 943 1003 975 162 1002 64 1007 937 870 871 871 937 942 804
774 921 774 774 774 905 943 1007 64 99 1007 507 1007 888 911 911 911 888 1007 804
373 999 372 871 871 937 942 64 99 443 1007 65 1007 842 810 774 774 774 774 774
911 911 911 911 911 914 945 98 442 65 1007 1007 905 811 870 871 871 871 871 871
507 65 1007 1007 1007 507 64 100 100 1007 1007 65 937 404 974 911 911 911 911 911
64 130 65 442 64 162 474 99 98 65 1007 410 1003 911 1007 65 1007 64 65 1007
1007 475 162 162 1007 162 1007 162 443 1007 1007 1007 905 778 942 474 65 410 474 1007
