0a003a0c
17 15
721 721 721 525 883 883 885 521 720 721 721 721 721 721 491
721 721 525 553 915 916 917 552 427 720 521 720 719 720 459
721 721 490 723 596 624 949 722 722 721 491 720 751 721 491
721 721 722 721 688 627 689 721 721 721 491 720 721 721 491
721 721 459 846 720 721 721 719 933 720 552 521 720 721 491
721 721 459 878 721 721 721 751 491 720 722 491 720 721 459
452 453 552 583 720 721 721 583 464 452 453 491 720 721 491
722 722 608 516 452 454 453 516 585 723 722 491 720 721 491
721 721 722 547 722 722 722 547 722 721 721 459 720 721 552
721 721 721 721 721 721 721 721 721 525 426 553 720 721 722
721 721 721 721 721 721 721 721 721 491 723 722 721 721 721
484 720 484 430 521 720 721 721 721 552 484 720 484 432 720
773 420 773 614 552 426 521 720 721 608 773 420 773 491 720
825 825 825 825 608 609 491 720 721 722 722 722 722 525 426
821 822 1 820 1 823 491 720 721 721 721 721 721 491 582
484 433 426 484 433 426 583 720 721 721 583 433 426 484 614
679 582 546 679 582 546 679 452 454 453 679 582 546 679 646
