0a009b0c
28 30
721 721 721 721 721 721 721 721 491 2 224 224 224 192 729 730 164 224 163 164 484 430 426 426 426 426 426 426 426 426
721 721 721 721 721 721 721 721 491 2 68 761 665 756 724 724 762 164 164 224 615 614 609 704 705 704 705 704 705 704
721 719 720 933 901 583 720 583 464 2 163 729 724 724 724 697 697 757 665 762 386 722 722 722 722 722 722 722 722 722
721 751 755 459 582 615 720 615 582 2 163 793 788 788 794 164 164 164 793 792 422 721 721 721 721 721 721 721 721 721
721 721 721 491 614 743 483 743 614 34 163 163 164 164 163 163 164 163 163 164 422 721 721 721 721 721 721 721 721 721
721 721 721 491 2 3 164 3 3 164 163 163 164 164 163 163 164 163 163 164 484 430 426 426 426 484 720 484 433 426
721 721 721 491 2 163 164 163 163 164 163 163 164 164 163 163 164 163 163 164 586 614 609 704 609 615 720 615 614 609
721 719 720 484 430 426 426 426 426 426 426 426 426 426 484 430 426 426 426 426 553 723 722 722 722 547 755 547 722 722
721 751 755 615 614 705 704 705 704 705 704 705 704 705 615 614 609 704 609 704 705 720 721 721 721 721 721 721 721 721
721 721 721 387 646 737 736 737 736 737 736 737 736 737 386 722 722 722 722 722 722 721 721 721 721 721 721 721 719 719
721 721 721 519 824 825 824 825 824 824 825 825 824 825 422 721 721 721 721 721 721 721 721 721 721 721 721 721 751 751
721 721 721 519 822 822 821 822 419 933 901 426 426 426 426 426 426 426 521 720 721 721 721 721 721 721 721 721 721 721
721 719 720 933 901 426 426 460 461 459 518 517 912 719 719 911 518 517 459 431 901 426 426 460 461 460 521 452 454 453
721 751 755 459 723 1 1 723 459 459 816 753 944 942 942 943 816 753 459 463 723 1 723 722 459 614 491 723 722 721
721 721 721 459 720 722 722 721 459 491 720 719 654 627 627 689 719 784 491 463 720 722 1 720 459 723 552 583 720 721
721 721 721 552 484 720 484 433 553 491 846 878 754 721 785 721 783 719 491 463 720 721 722 721 459 720 704 615 720 721
721 721 721 704 615 420 615 614 705 491 878 754 721 785 721 785 721 783 491 433 484 720 484 430 553 720 722 387 720 721
721 721 721 722 547 722 547 722 722 552 426 429 683 720 785 683 430 426 553 614 615 420 615 614 705 720 721 519 721 721
719 719 720 721 721 721 721 721 721 704 705 705 615 784 721 615 614 704 705 723 547 722 547 722 722 721 933 583 720 721
751 751 755 721 721 721 721 721 721 736 737 737 775 452 453 775 646 736 737 720 721 721 721 721 721 721 459 616 720 721
721 721 721 721 721 721 721 721 721 722 722 722 547 722 722 547 722 722 722 721 721 721 721 721 721 721 491 809 720 721
721 721 721 721 721 721 721 721 721 721 721 721 721 721 721 721 721 721 721 721 721 721 721 721 721 721 491 869 755 721
426 426 426 426 426 583 720 721 721 583 430 426 426 426 426 426 521 720 721 721 721 721 721 721 721 721 491 720 721 721
705 704 705 704 705 615 720 721 721 615 614 705 704 705 704 705 525 462 426 583 720 721 583 430 426 426 553 720 721 721
737 736 737 736 737 775 452 454 453 775 646 737 736 737 736 737 459 614 705 615 720 721 615 614 705 704 705 720 721 721
825 825 824 825 824 870 824 825 824 870 825 825 824 825 825 825 459 646 737 775 452 453 775 646 737 736 737 720 721 721
822 822 821 822 821 822 822 821 822 822 821 822 822 821 822 822 459 723 722 838 722 722 838 722 722 722 722 721 721 721
822 822 821 822 821 822 822 821 822 822 821 822 822 821 822 822 459 720 721 721 721 721 721 721 721 721 721 721 721 721
