8e008f90
48 32
19 19 19 19 37 19 19 19 19 19 19 19 19 19 19 19 19 19 19 19 19 19 19 19 19 19 19 19 19 19 19 19
19 19 19 19 37 22 23 24 19 19 19 19 19 19 19 19 19 19 19 19 19 19 19 19 19 19 19 19 19 19 19 19
19 19 19 52 53 54 55 56 57 58 19 19 19 19 19 19 19 19 19 19 19 19 19 19 19 19 19 19 19 19 19 19
19 19 135 84 85 86 87 88 89 90 138 19 19 19 19 19 19 19 19 19 19 19 19 19 19 19 19 19 19 19 19 19
19 19 167 116 117 118 119 120 121 122 170 19 19 19 19 19 19 22 23 24 19 19 19 19 19 19 19 19 19 19 19 19
19 19 199 148 149 150 151 152 153 154 202 19 19 19 19 52 53 54 55 56 57 58 19 19 19 19 19 19 19 19 19 19
19 19 231 180 181 182 183 184 185 186 234 19 19 19 135 84 85 86 87 88 89 90 138 19 19 19 19 19 19 19 19 19
19 19 263 212 213 214 215 216 217 218 266 19 19 19 167 116 117 118 119 120 121 122 170 19 19 19 19 19 19 19 19 19
19 19 295 244 245 246 247 248 249 250 298 19 19 19 199 148 149 150 151 152 153 154 202 19 19 19 19 19 19 19 19 19
19 19 19 192 193 278 279 280 197 198 19 19 19 19 231 180 181 182 183 184 185 186 234 19 19 19 19 19 19 19 19 19
19 19 19 224 225 103 37 105 229 230 19 19 37 37 37 212 213 214 215 216 217 218 37 37 37 37 19 19 19 19 19 19
19 19 19 256 257 103 37 260 261 262 19 19 37 19 295 244 245 246 247 248 249 250 298 19 19 37 19 19 19 19 19 19
19 19 19 352 353 258 37 260 357 358 19 19 37 19 19 192 193 194 195 196 197 198 19 19 19 37 22 23 24 19 19 19
19 19 19 448 449 322 37 37 37 37 37 37 37 19 19 224 225 103 104 105 229 230 19 19 52 53 54 55 56 57 58 19
19 19 19 384 385 322 259 388 389 390 19 19 19 19 19 256 257 258 259 260 261 262 19 135 84 85 86 87 88 89 90 138
19 19 19 384 385 322 259 388 389 390 19 19 19 19 19 352 353 258 259 260 357 358 19 167 116 117 118 119 120 121 122 170
19 19 19 384 385 322 259 388 389 390 19 19 19 19 19 448 449 322 259 452 453 454 19 199 148 149 150 151 152 153 154 202
19 19 19 384 385 322 259 388 389 390 19 19 19 19 19 384 385 322 259 388 389 390 19 231 180 181 182 183 184 185 186 234
19 19 19 384 385 322 259 388 389 390 19 19 19 19 19 416 417 418 419 420 389 390 19 263 212 213 214 215 216 217 218 266
19 19 19 384 385 322 259 388 389 390 19 19 19 19 19 22 23 24 392 392 421 422 19 295 244 245 246 247 248 249 250 298
19 19 19 416 417 418 419 420 421 422 19 19 19 52 53 54 55 56 57 58 392 392 19 19 192 193 278 279 280 197 198 19
19 19 19 392 22 23 24 392 392 392 19 19 135 84 85 86 87 88 89 90 138 392 19 19 224 225 103 37 105 229 230 19
19 19 52 53 54 55 56 57 58 392 19 19 167 116 117 118 119 120 121 122 170 392 19 19 256 257 258 37 260 261 262 19
19 135 84 85 86 87 88 89 90 138 19 19 199 148 149 150 151 152 153 154 202 392 19 19 352 353 258 37 260 357 358 19
19 167 116 117 118 119 120 121 122 170 19 19 231 180 181 182 183 184 185 186 234 392 19 19 448 37 37 37 356 453 454 19
19 199 148 149 150 151 152 153 154 202 19 37 37 212 213 214 215 216 217 218 37 37 37 37 37 37 258 259 388 389 390 19
19 231 180 181 182 183 184 185 186 234 19 37 295 244 245 246 247 248 249 250 329 392 19 19 384 385 322 259 388 389 390 19
19 263 212 213 214 215 216 217 218 37 37 37 19 192 193 194 195 196 197 198 392 392 19 19 384 385 322 259 388 389 390 19
19 295 244 245 246 247 248 249 250 329 19 19 19 224 225 103 104 105 229 230 392 392 19 19 384 385 322 259 388 389 390 19
19 19 192 193 278 279 280 197 198 392 19 19 19 256 257 258 259 260 261 262 392 392 19 19 384 385 322 259 388 389 390 19
19 19 224 225 103 37 105 229 230 392 19 19 19 352 353 258 259 356 357 358 392 392 19 19 384 385 322 259 388 389 390 19
19 19 256 257 258 37 260 261 262 392 19 19 19 448 449 322 259 452 453 454 392 392 19 19 416 417 418 419 420 421 422 19
19 19 352 353 258 37 356 357 358 392 19 19 19 384 385 322 259 388 389 390 392 392 19 19 392 392 392 392 392 392 392 19
19 19 448 449 322 37 22 23 24 392 19 19 19 384 385 322 259 388 389 390 392 392 19 19 392 392 392 392 392 392 392 19
19 19 384 385 52 53 54 55 56 57 58 19 19 384 385 322 259 98 99 100 392 392 19 19 392 392 392 392 392 392 392 19
19 19 384 135 84 85 86 87 88 89 90 138 19 384 385 128 129 130 35 132 133 134 19 19 392 392 392 392 392 392 392 19
19 19 384 167 116 117 118 119 120 121 122 170 19 384 135 136 8 70 43 38 6 137 138 19 392 392 392 392 392 392 392 19
19 19 384 199 148 149 150 151 152 153 154 202 19 416 167 168 7 5 5 5 5 169 170 19 392 392 392 392 392 392 392 19
19 19 416 231 180 181 182 183 184 185 186 234 19 392 199 200 7 5 5 5 5 201 202 19 392 392 392 392 392 392 392 19
19 19 392 296 212 213 214 215 216 217 218 266 19 392 231 34 9 5 5 5 5 233 234 19 392 392 392 392 392 392 392 19
19 19 392 328 244 245 246 247 248 249 250 298 37 37 37 40 5 5 5 5 5 265 266 19 392 392 392 392 392 392 392 19
19 19 392 392 192 193 278 279 280 197 198 19 37 392 328 64 161 162 7 164 165 166 298 19 392 392 392 392 392 392 392 19
19 19 392 392 224 225 103 37 37 37 37 37 37 392 392 192 193 71 7 73 197 198 19 128 129 129 129 129 129 129 129 129
19 19 392 392 256 257 258 259 388 261 262 19 19 392 392 224 225 103 37 105 229 230 19 232 8 6 6 6 6 6 6 6
19 19 392 392 352 353 258 259 388 357 358 19 19 392 392 256 257 258 37 37 37 37 37 34 5 5 5 5 5 5 5 5
19 19 392 392 448 449 322 259 452 453 454 19 19 392 392 352 353 258 37 37 37 37 37 40 5 5 5 5 5 5 5 5
19 19 392 392 384 385 322 259 388 389 390 19 19 392 392 448 449 322 259 452 453 454 19 64 161 162 7 5 5 5 164 161
19 19 392 392 384 385 322 259 388 389 390 19 19 392 392 384 385 322 259 388 389 390 19 192 192 71 7 5 5 5 73 192
