5300bdbe
27 28
160 160 160 160 160 160 160 160 160 160 160 160 257 1 100 134 164 103 103 34 34 42 43 44 168 169 168 44
354 353 352 160 160 160 160 160 160 160 357 416 352 483 484 196 257 134 66 103 102 42 43 44 43 35 13 44
386 228 384 352 160 160 160 357 416 289 389 228 384 290 160 160 160 261 34 34 134 74 77 44 44 43 44 44
103 1 2 322 288 416 293 389 448 321 66 102 103 322 290 353 352 160 484 486 100 39 109 43 44 43 44 43
134 70 39 103 320 448 325 102 34 102 100 1 2 66 322 385 384 290 289 325 38 131 74 75 64 65 97 76
34 38 106 39 103 108 102 34 66 66 38 71 66 66 66 102 34 322 321 34 130 98 39 103 132 132 132 34
259 134 34 38 131 71 100 34 100 38 256 483 261 134 135 134 66 66 38 38 98 98 71 66 70 131 71 135
160 257 134 70 71 66 103 134 38 71 226 160 160 483 484 257 34 38 131 98 71 71 260 486 134 70 39 103
160 416 486 34 132 164 103 1 2 66 290 160 160 160 160 160 261 70 131 71 66 260 420 325 66 102 38 131
291 448 325 38 163 70 66 70 39 66 322 419 160 160 160 160 420 34 71 1 2 226 420 34 102 38 131 131
323 34 102 131 71 258 259 164 38 135 485 160 160 160 160 160 293 102 66 34 66 290 160 261 38 131 71 70
261 71 70 70 71 290 160 261 70 103 322 292 160 160 160 293 325 66 66 39 135 322 419 420 70 101 34 66
289 39 34 100 106 322 419 420 34 39 103 324 288 416 291 325 102 38 39 70 260 484 160 227 66 1 2 102
323 70 39 39 66 34 419 160 257 38 39 103 320 228 323 34 66 38 39 34 290 160 160 293 34 102 98 39
483 195 66 70 39 66 292 160 291 70 131 39 39 132 103 132 66 70 163 103 322 419 420 325 38 130 98 71
160 160 486 66 70 39 324 451 323 38 131 131 39 1 2 100 138 139 70 135 34 288 160 257 70 162 71 66
160 291 325 66 66 34 258 160 259 70 71 70 70 71 34 134 38 39 1 2 103 320 419 160 486 70 39 66
420 325 102 1 2 66 290 160 160 483 484 257 66 260 196 261 70 98 131 39 34 260 160 293 325 34 38 39
160 259 100 38 98 135 322 292 160 160 160 160 483 416 416 293 38 98 98 71 194 160 420 325 66 38 98 71
160 160 257 70 162 39 66 324 290 355 352 416 289 448 448 325 38 98 71 260 160 160 160 261 38 131 71 66
160 160 289 134 70 131 103 34 322 387 384 448 321 102 38 131 39 71 256 160 160 160 160 227 34 1 2 66
416 293 321 100 38 131 39 38 39 66 38 39 66 38 131 131 39 485 160 160 355 416 416 289 102 131 39 66
448 325 102 38 130 71 71 130 98 98 130 71 70 98 98 106 71 324 290 289 387 448 448 321 100 131 131 39
34 102 70 70 98 39 135 71 66 70 98 39 66 70 70 71 101 34 322 321 102 34 103 102 38 131 131 71
38 39 34 100 70 98 39 260 483 261 71 34 1 2 100 70 108 39 34 102 102 38 39 38 131 71 1 2
98 98 39 135 106 98 71 290 160 420 164 134 66 164 135 38 140 131 39 132 38 131 131 98 98 131 71 135
70 98 71 66 38 71 34 322 160 160 261 258 196 257 71 70 131 71 70 98 98 71 70 71 70 71 135 34
