2c005d2e
32 32
491 784 458 518 517 517 517 517 458 768 617 618 768 770 771 772 768 617 618 768 491 518 517 517 517 517 525 426 427 427 427 521
491 720 459 752 817 753 817 419 491 800 649 650 800 802 803 804 800 649 650 800 458 419 817 753 817 753 459 823 825 824 825 491
458 784 459 784 721 785 721 785 491 832 681 682 832 834 835 836 832 681 682 832 491 784 721 785 721 785 459 820 33 820 821 458
491 720 496 720 785 721 785 721 458 864 850 656 865 595 624 595 865 657 850 864 459 720 785 721 785 721 458 820 824 821 33 458
458 784 459 784 721 484 720 785 491 848 849 688 627 690 625 691 627 689 849 849 459 784 721 484 720 785 484 416 484 495 823 458
484 430 484 720 785 491 784 721 458 848 849 849 688 688 627 689 689 849 849 849 458 720 785 491 784 721 516 420 516 459 820 459
544 546 459 784 721 458 720 785 458 880 852 852 852 852 852 852 852 852 852 852 491 784 721 458 720 785 547 786 547 491 33 491
608 609 491 720 785 491 784 721 484 430 427 427 427 484 880 852 484 430 427 427 484 720 785 491 784 721 785 721 785 458 823 458
736 737 458 784 721 458 720 785 516 518 517 517 517 516 452 453 516 518 517 517 516 784 721 458 720 785 721 785 721 491 820 458
724 794 458 720 785 458 784 721 548 753 817 753 817 547 786 722 548 753 817 753 548 721 785 458 784 721 785 721 785 458 33 491
794 162 491 784 721 491 720 785 721 785 721 785 721 785 721 785 721 785 721 785 721 785 721 491 720 785 721 785 721 458 823 458
66 164 458 419 785 458 784 721 785 721 785 721 785 721 785 721 785 721 785 721 785 721 785 458 784 721 785 721 785 491 33 491
525 426 427 427 426 427 484 784 721 785 484 430 426 426 427 427 426 427 427 426 427 426 427 426 427 521 720 785 721 458 820 458
491 823 825 824 824 825 459 720 785 721 459 851 853 853 853 853 853 853 853 853 853 853 853 853 853 458 784 721 785 484 430 484
458 820 821 821 821 821 459 784 721 785 459 848 849 849 849 849 849 849 849 849 849 849 849 849 849 459 720 785 721 459 582 546
459 820 821 525 484 416 484 720 785 721 484 417 418 484 557 426 427 426 426 427 427 426 427 848 849 491 784 721 785 459 614 705
491 33 820 491 516 420 516 784 721 785 516 452 453 516 491 851 853 853 853 853 853 853 853 849 849 458 720 785 721 459 614 705
458 823 821 458 864 722 548 721 785 721 548 722 786 547 458 848 849 849 849 849 849 849 849 849 849 459 784 721 785 459 646 737
459 820 33 491 720 785 721 785 721 785 721 785 721 785 459 484 848 849 484 430 427 427 427 427 460 493 720 785 721 587 2 162
491 820 825 459 784 721 785 721 785 721 785 721 785 721 491 516 452 453 516 518 517 517 517 517 517 458 784 721 785 555 2 164
458 33 820 459 720 785 721 785 721 785 721 785 721 785 458 864 722 786 547 817 753 817 753 817 753 491 720 785 721 587 2 66
491 823 821 552 427 484 784 721 785 721 785 721 785 721 491 720 785 721 785 721 785 721 785 721 785 458 784 721 484 430 427 484
491 820 33 823 825 459 419 785 721 785 721 785 721 419 458 784 721 785 721 785 721 785 721 785 721 458 720 785 458 823 419 459
458 820 824 33 820 491 430 427 426 427 426 427 426 426 426 521 784 721 785 721 520 427 426 427 460 583 784 583 459 820 824 459
484 430 427 427 427 484 582 579 580 579 580 579 580 546 583 583 720 785 721 785 583 584 582 580 546 615 451 615 484 430 426 484
544 579 580 579 580 546 614 707 708 707 708 707 708 705 615 583 784 721 785 721 583 616 614 708 705 647 451 647 544 579 580 546
608 611 612 611 612 609 646 739 740 739 740 739 740 737 647 615 720 785 721 785 615 648 646 740 737 679 483 679 608 611 612 609
640 643 644 643 644 641 2 3 3 4 35 4 35 35 679 647 452 454 454 453 647 680 2 35 36 711 693 711 640 643 644 641
672 675 676 675 676 673 34 163 100 67 99 67 100 165 711 679 452 454 454 453 679 712 34 163 164 35 727 35 672 675 676 673
3 3 3 3 3 3 165 67 165 133 100 133 194 194 193 711 452 454 454 453 711 34 194 192 67 194 727 194 193 4 35 36
224 224 224 224 224 195 194 192 67 133 195 194 192 67 67 99 729 724 724 730 4 195 194 194 194 761 724 762 195 224 224 224
756 665 756 665 665 756 756 756 665 665 756 756 756 665 665 665 724 724 724 724 665 756 665 756 665 724 724 724 756 665 756 756
