91009293
11 15
61 340 61 441 282 282 252 813 854 264 401 401 271 148 21
93 180 93 180 180 180 250 409 853 270 401 305 307 186 122
180 180 55 213 180 180 250 408 273 401 271 775 198 177 273
180 180 54 182 180 180 250 344 306 401 401 273 176 775 238
180 180 180 180 180 180 250 813 794 270 401 401 401 263 269
282 282 282 315 180 314 284 53 854 144 401 401 401 401 401
24 21 21 21 214 22 21 149 854 230 401 401 401 401 401
154 186 186 187 340 186 122 187 853 775 270 401 401 401 305
199 71 775 775 306 273 337 275 262 273 401 401 401 271 775
401 209 133 775 775 396 775 230 401 401 401 401 401 401 209
433 199 775 198 145 401 263 274 401 401 401 401 401 401 199
