91009293
26 25
422 429 888 917 853 165 204 401 433 401 177 307 85 247 244 245 85 854 85 318 180 180 180 180 250
422 528 116 21 21 21 21 21 21 21 21 21 149 248 1 248 53 854 53 318 180 180 180 180 250
746 560 53 220 282 282 282 282 252 278 279 278 279 244 279 245 53 854 85 318 180 180 180 180 250
743 679 85 318 55 213 180 55 318 116 21 21 21 23 248 22 149 854 53 318 180 180 180 180 250
544 915 53 318 54 182 180 54 345 53 154 122 122 187 340 186 187 853 85 351 315 180 314 282 284
454 918 85 351 282 281 281 282 284 53 854 775 198 177 401 305 401 205 148 23 813 214 813 22 21
646 919 148 23 813 351 284 813 22 149 854 133 238 775 238 775 230 265 186 187 845 340 845 154 122
544 884 186 187 845 309 310 845 154 187 853 165 775 70 71 775 100 230 337 337 337 305 263 272 262
589 624 133 240 401 305 401 401 145 337 273 273 275 116 21 21 21 21 117 794 133 775 230 401 401
71 67 689 236 231 775 230 305 307 775 230 401 401 85 220 282 282 252 85 854 133 100 775 230 177
689 654 116 21 21 21 21 21 117 794 775 238 230 53 318 1 1 318 53 854 165 775 775 100 775
652 70 85 246 278 278 278 278 85 854 133 775 67 85 318 181 181 285 53 854 268 274 273 199 198
71 102 53 247 312 244 244 312 53 854 775 133 67 148 23 214 180 22 149 854 116 21 21 21 21
103 775 85 247 244 244 312 244 53 854 133 775 67 186 187 309 310 186 187 853 85 220 282 282 282
202 207 148 21 23 247 22 21 149 854 775 775 99 300 306 305 401 401 401 209 85 318 180 55 214
236 401 222 222 222 340 222 222 222 853 775 775 206 775 206 775 144 401 401 775 53 318 180 54 182
689 230 401 401 401 305 401 401 241 775 208 337 401 145 401 273 401 401 401 209 85 351 315 180 314
98 775 230 401 271 775 230 116 21 21 21 21 21 21 339 21 21 21 117 775 148 21 23 214 22
79 71 775 144 297 133 775 85 212 181 181 181 181 181 627 212 181 181 85 956 186 122 187 340 186
38 103 98 238 775 165 775 53 213 55 213 180 180 180 181 180 55 213 53 854 775 133 198 305 273
103 775 130 775 162 268 274 85 213 54 182 180 180 180 596 213 54 180 53 854 775 775 238 775 230
199 198 273 199 775 270 401 53 564 563 563 660 213 661 52 813 213 813 149 854 775 112 80 206 165
401 401 401 401 209 230 401 85 246 278 278 627 213 181 85 846 340 845 223 853 99 208 337 369 775
401 401 401 401 199 775 270 53 247 1 247 278 180 180 53 370 401 401 297 775 71 775 775 270 199
401 401 401 401 401 273 401 85 247 278 244 596 213 180 53 370 401 401 265 775 268 207 775 270 401
401 401 401 401 401 401 401 148 21 21 21 21 21 21 149 370 401 401 401 145 401 401 273 401 401
