91009293
26 25
422 429 888 917 853 165 204 401 433 401 177 307 4 115 115 115 49 854 4 115 115 115 115 115 115
422 528 16 17 17 17 17 17 17 17 17 17 18 115 115 115 50 854 4 115 115 115 115 115 115
746 560 48 115 115 115 115 115 115 51 51 51 51 51 51 51 50 854 4 115 115 115 115 115 115
743 679 48 115 115 115 115 115 115 371 21 21 21 23 755 22 149 854 4 115 115 115 115 115 115
544 915 48 115 115 115 115 115 115 50 154 122 122 187 340 186 187 853 4 115 115 115 115 115 115
454 918 48 51 51 51 51 51 51 49 854 775 198 177 401 305 401 205 148 23 813 755 813 22 21
646 919 148 23 813 756 757 813 22 149 854 133 238 775 238 775 230 265 186 187 845 340 845 154 122
544 884 186 187 845 309 310 845 154 187 853 165 775 70 71 775 100 230 337 337 337 305 263 272 262
589 624 133 240 401 305 401 401 145 337 273 273 275 16 17 17 17 17 19 794 133 775 230 401 401
71 67 689 236 231 775 230 305 307 775 230 401 401 4 115 115 115 115 50 854 133 100 775 230 177
689 654 16 17 17 17 17 17 19 794 775 238 230 4 115 115 115 115 50 854 165 775 775 100 775
652 70 4 115 115 115 115 115 50 854 133 775 67 4 51 51 51 51 49 854 268 274 273 199 198
71 102 4 115 115 115 115 115 50 854 775 133 67 148 23 756 757 22 149 854 16 17 17 17 17
103 775 4 51 51 51 51 51 49 854 133 775 67 186 187 309 310 186 187 853 4 115 115 115 115
202 207 148 21 23 755 22 21 149 854 775 775 99 300 306 305 401 401 401 209 4 115 115 115 115
236 401 222 222 222 340 222 222 222 853 775 775 206 775 206 775 144 401 401 775 4 115 115 115 115
689 230 401 401 401 305 401 401 241 775 208 337 401 145 401 273 401 401 401 209 4 115 115 115 115
98 775 230 401 271 775 230 16 17 17 17 17 17 17 17 17 17 17 19 775 148 21 23 755 22
79 71 775 144 297 133 775 4 115 115 115 115 115 115 115 115 115 115 50 956 186 122 187 340 186
38 103 98 238 775 165 775 4 115 115 115 115 115 115 115 115 115 115 50 854 775 133 198 305 273
103 775 130 775 162 268 274 4 115 115 115 115 115 115 51 51 51 51 49 854 775 775 238 775 230
199 198 273 199 775 270 401 4 115 115 115 115 115 115 371 813 755 813 149 854 775 112 80 206 165
401 401 401 401 209 230 401 4 115 115 115 115 115 115 50 846 340 845 223 853 99 208 337 369 775
401 401 401 401 199 775 270 4 115 115 115 115 115 115 50 370 401 401 297 775 71 775 775 270 199
401 401 401 401 401 273 401 4 51 51 51 51 51 51 49 370 401 401 265 775 268 207 775 270 401
401 401 401 401 401 401 401 148 21 21 21 21 21 21 149 370 401 401 401 145 401 401 273 401 401
