81008283
32 32
417 160 417 291 608 547 548 578 547 291 134 291 608 515 578 579 546 547 515 291 134 291 608 515 291 416 417 417 291 416 160 417
417 417 417 323 608 546 546 515 515 384 258 385 577 547 515 547 515 516 546 384 258 385 577 516 323 416 417 417 323 416 417 417
214 417 215 325 608 515 548 546 579 640 642 643 513 578 579 515 546 547 578 640 642 643 513 579 291 416 417 417 213 214 417 215
246 416 247 323 608 515 5 579 547 515 548 546 547 515 548 546 547 515 548 546 547 515 548 547 6 416 417 417 245 246 416 247
418 448 418 291 608 547 291 547 547 288 256 256 256 256 256 256 256 256 256 256 256 289 546 578 38 416 417 417 418 418 448 418
417 417 417 323 608 578 291 544 547 352 6 148 149 6 262 258 258 6 148 149 6 353 516 547 70 167 168 5 417 417 417 417
417 134 417 291 544 547 323 608 515 291 39 180 181 39 6 6 6 38 180 181 38 291 608 578 641 199 168 291 417 417 134 417
417 417 417 291 608 515 291 544 547 291 70 449 12 70 39 2 38 70 12 416 70 291 544 547 515 642 643 323 416 417 417 417
417 1 416 323 544 547 291 608 547 323 416 134 12 75 70 34 70 75 12 134 418 323 608 515 5 516 547 291 416 1 416 417
417 418 448 291 544 547 291 544 514 291 416 417 44 75 75 75 75 75 44 448 417 291 544 578 276 547 578 291 416 418 448 417
417 1 416 323 608 514 291 544 547 291 416 417 417 417 75 75 75 417 417 448 417 291 544 547 308 544 547 323 449 417 417 417
417 418 448 323 544 547 291 608 547 323 416 417 417 193 132 132 132 194 417 417 417 323 608 514 276 544 578 291 416 1 416 417
417 1 416 291 608 547 323 544 515 291 416 417 417 133 162 23 162 165 417 417 417 291 544 547 308 544 547 323 416 418 448 417
6 418 448 6 544 515 291 608 547 291 416 417 12 25 54 55 56 22 12 416 417 291 608 578 276 608 514 291 416 417 417 417
42 416 417 42 544 547 291 544 547 291 416 417 44 35 86 87 88 165 44 448 417 323 544 514 308 544 547 323 416 1 416 417
74 167 168 74 544 547 323 544 546 291 416 417 417 99 118 119 120 165 417 417 417 291 544 546 276 608 578 291 416 418 448 417
106 167 168 107 513 578 291 544 547 291 416 417 134 133 162 24 162 165 134 417 417 323 544 516 308 544 514 323 416 417 417 417
546 642 640 513 546 547 323 608 578 291 416 417 417 225 164 164 164 226 417 417 417 291 544 515 276 544 546 323 416 417 417 417
258 259 6 262 258 259 6 544 546 357 294 258 258 6 417 417 417 6 262 258 258 6 544 546 308 544 516 6 6 417 417 6
17 18 39 16 17 18 39 576 514 291 80 81 82 43 416 417 417 42 83 84 85 42 608 547 276 544 515 38 38 417 417 38
49 50 70 48 49 50 70 608 579 323 112 113 114 74 167 169 168 74 115 116 117 74 544 578 276 544 546 70 70 167 168 70
677 678 679 676 677 678 679 513 579 291 512 642 643 106 199 169 168 107 640 642 643 106 513 516 276 608 547 642 643 199 168 512
579 515 546 547 578 579 546 547 547 323 609 578 579 546 642 640 643 513 578 579 515 546 547 515 308 544 578 515 546 642 643 513
515 546 547 5 240 241 308 579 515 5 152 151 151 151 151 151 151 151 151 151 151 5 516 546 276 6 547 546 546 6 240 241
547 578 579 6 144 147 244 546 547 323 182 183 183 183 183 183 183 183 183 183 183 291 546 515 308 40 579 578 515 40 144 145
547 515 547 40 176 179 276 544 578 291 449 418 418 418 418 418 418 418 418 418 418 291 609 547 276 72 577 546 546 72 176 177
578 578 579 72 208 211 308 544 547 323 416 417 417 417 417 417 417 417 417 417 417 323 544 579 308 104 167 169 168 104 208 209
167 169 168 104 483 485 276 608 515 6 262 258 258 6 262 258 259 6 262 258 259 6 576 547 276 136 199 169 168 136 484 485
167 169 168 136 482 482 308 544 578 38 16 17 18 38 19 20 21 38 19 20 21 38 576 578 308 480 485 485 485 482 481 482
485 484 485 482 481 481 276 544 547 70 48 49 50 70 51 52 53 70 51 52 53 70 577 515 276 480 482 482 482 482 482 482
482 482 481 482 482 481 308 544 515 643 676 677 678 679 676 677 678 679 676 677 678 679 513 546 308 480 482 481 482 482 481 482
481 481 482 481 481 482 276 544 547 514 546 547 578 579 546 547 515 546 547 546 547 515 546 547 276 480 481 482 482 481 482 482
