1c1d1e1f
10 15
163 163 782 163 631 571 598 599 571 598 99 900 836 631 662
163 720 163 596 629 70 77 720 12 14 75 331 874 599 694
783 163 163 600 134 38 137 44 43 47 107 99 99 685 632
815 782 163 600 102 114 103 857 858 859 132 100 100 679 696
163 163 631 598 163 198 205 889 890 891 395 720 100 711 628
538 539 598 163 204 433 265 921 922 923 368 199 100 684 711
742 163 163 782 236 177 401 199 396 198 433 297 720 100 65
545 497 743 163 784 785 300 306 305 403 295 235 99 782 133
616 586 425 497 163 163 932 98 720 238 100 685 679 266 269
513 429 618 465 163 163 198 199 163 100 684 711 64 234 306
