1c1d441f
15 17
100 100 100 100 599 630 100 720 559 746 560 664 559 746 716 779 513
932 100 70 77 8 600 13 99 64 782 65 632 711 807 808 809 495
71 932 142 137 35 632 13 720 100 108 45 600 64 839 840 841 559
80 43 114 103 596 598 100 99 782 70 41 601 100 871 874 873 65
137 41 720 596 605 100 100 782 70 81 35 600 13 14 720 70 79
103 35 100 604 598 395 100 70 114 38 45 600 100 102 82 38 114
631 571 602 605 100 144 199 783 100 46 720 628 630 782 102 103 782
598 12 599 634 630 230 231 631 34 630 66 782 628 539 597 99 100
135 14 100 100 628 603 34 598 100 600 98 848 785 100 599 34 538
6 80 100 41 631 598 100 782 100 628 603 597 100 783 98 16 631
38 103 100 35 600 13 100 100 100 100 600 599 597 815 631 539 598
105 720 70 71 600 100 100 100 631 539 598 782 599 603 598 35 198
175 100 112 103 628 597 631 34 598 100 100 100 100 599 597 41 933
137 14 106 782 100 628 598 100 100 782 100 100 782 17 600 35 933
38 169 720 70 109 100 782 100 100 100 100 782 100 100 599 597 331
