1c1d1e1f
17 18
903 904 905 100 626 715 589 596 629 495 616 779 530 168 169 559 513 465
935 936 937 100 64 65 64 601 99 748 592 64 65 102 137 804 495 579
967 875 969 100 100 782 3 36 101 64 260 390 133 720 113 71 559 715
100 100 100 163 196 572 596 605 782 198 369 133 268 203 102 103 64 65
631 597 7 631 570 635 598 599 597 296 401 145 295 299 100 99 141 720
598 599 39 598 99 900 836 631 662 200 231 238 720 100 100 100 102 82
77 720 11 14 75 331 389 599 694 301 804 720 100 100 100 100 99 102
137 44 43 47 107 99 99 685 632 557 648 903 904 905 711 679 685 70
103 857 858 859 132 100 100 679 696 751 687 935 936 937 685 65 163 102
205 889 890 891 395 720 100 711 628 597 685 967 968 969 78 720 14 785
265 921 922 923 368 199 100 684 711 600 100 260 293 70 38 82 38 71
401 199 396 198 433 297 720 100 65 600 332 333 720 102 114 114 6 143
300 306 305 403 295 235 99 782 133 628 597 396 100 67 163 720 102 103
932 98 720 238 100 685 679 266 269 100 600 368 199 932 100 817 784 679
198 199 163 100 684 711 64 234 306 145 2 433 401 205 100 784 742 711
433 176 804 686 775 776 777 99 932 359 2 305 295 235 784 655 623 497
307 301 626 424 649 745 720 99 99 782 600 932 932 720 591 623 618 465
