1c1d441f
15 17
100 100 100 100 599 630 100 720 559 746 560 664 559 746 716 779 513
932 100 70 77 3 36 101 99 64 782 65 632 711 903 904 905 495
71 932 142 137 3 36 101 720 100 108 45 600 64 935 936 937 559
80 43 114 103 596 598 100 99 782 70 45 601 100 967 875 969 65
137 100 720 596 605 100 100 782 70 81 3 36 101 14 720 70 79
103 7 100 604 598 395 100 70 114 38 45 600 100 102 82 38 114
631 39 602 605 100 144 199 783 100 46 720 628 630 782 102 103 782
598 11 599 634 630 230 231 631 34 630 66 782 628 539 597 99 100
135 14 100 100 628 603 34 598 100 600 98 848 785 100 599 34 538
6 80 100 100 631 598 100 782 100 628 603 597 100 783 98 10 631
38 103 100 3 36 101 100 100 100 100 600 599 597 815 631 4 598
105 720 70 71 600 100 100 100 631 539 598 782 599 603 598 9 198
175 100 112 103 628 597 631 34 598 100 100 100 100 599 597 100 933
137 14 106 782 100 628 598 100 100 782 100 100 782 68 37 69 933
38 169 720 70 109 100 782 100 100 100 100 782 100 100 599 597 331
