1c1d1e1f
17 24
67 98 70 6 71 493 459 586 522 528 653 174 6 71 782 296 271 720 14 652 653 685 132 132
98 720 102 38 169 655 616 779 558 687 685 136 38 103 641 264 297 70 6 80 851 852 853 132
67 67 70 114 45 748 560 652 653 685 76 38 103 720 198 869 237 102 114 107 883 884 885 132
67 76 137 782 67 685 65 67 98 675 136 81 782 204 433 433 199 131 720 71 915 916 917 132
685 136 6 71 67 67 804 98 677 44 38 6 45 356 294 869 177 199 70 73 134 82 79 45
67 102 38 6 71 67 196 673 229 804 166 103 395 99 676 238 66 296 147 114 38 6 103 720
140 720 113 38 103 99 677 499 228 771 67 817 396 67 817 672 773 234 301 782 102 103 131 131
113 103 102 103 98 163 704 67 782 67 782 67 359 783 67 67 737 197 67 100 131 131 131 131
102 109 67 99 67 228 720 782 67 783 395 880 785 720 131 784 882 674 772 197 67 99 720 131
903 904 905 70 82 79 79 71 880 946 360 815 67 67 720 131 815 133 720 676 505 508 131 677
935 936 937 102 167 172 102 103 133 67 720 395 782 720 131 720 131 100 131 131 144 436 473 199
967 968 969 198 390 133 133 100 784 785 198 231 720 67 67 720 131 785 131 208 433 805 295 301
100 230 337 177 263 272 274 199 720 198 293 903 904 905 720 131 783 131 98 131 300 235 70 15
57 52 118 46 360 336 294 271 782 360 783 935 936 937 131 784 914 720 131 131 70 82 38 6
125 477 478 54 119 99 99 300 358 720 67 967 968 969 720 131 815 131 782 804 102 111 111 38
477 478 477 478 124 131 98 67 720 131 782 131 230 337 337 337 275 203 720 395 836 900 900 102
509 510 509 510 478 56 66 132 782 67 720 131 784 785 720 782 359 325 262 435 273 273 273 199
