1c1d1e1f
27 21
100 463 423 582 426 461 716 719 67 938 939 940 65 748 615 425 429 465 100 559 587
782 495 424 553 424 528 64 64 99 970 971 972 130 64 559 491 460 464 593 65 559
67 463 459 615 424 496 98 932 131 909 910 911 720 932 783 495 544 465 70 71 64
98 431 549 453 456 496 99 932 98 99 142 6 71 932 815 495 616 528 142 103 100
130 65 495 485 523 545 497 743 932 932 6 6 103 743 591 616 429 465 46 900 836
71 100 559 525 523 616 586 425 497 70 6 103 591 459 613 617 464 560 131 783 99
6 720 65 559 525 513 429 618 465 142 6 71 495 491 582 545 465 64 14 815 131
6 82 45 65 559 715 545 492 592 112 6 143 559 587 617 618 560 70 6 71 720
6 103 783 100 64 65 748 560 67 100 102 143 65 495 623 592 64 142 111 103 100
6 71 815 720 14 100 64 65 140 14 720 46 98 431 589 782 44 103 743 720 679
111 6 71 44 6 79 71 782 102 6 6 79 45 65 785 785 785 591 459 561 591
77 102 103 782 102 6 6 45 720 102 111 103 720 99 100 626 623 583 616 615 587
73 141 932 932 70 111 103 742 743 782 743 782 98 742 782 655 520 545 528 559 715
111 6 71 70 143 720 591 580 491 613 424 497 591 456 613 616 583 427 687 64 64
561 102 6 6 103 626 525 417 386 582 459 460 583 609 714 494 779 558 70 79 79
545 561 102 6 71 785 559 747 494 779 746 716 560 751 687 67 64 64 102 6 103
459 460 561 102 103 98 64 64 100 64 64 784 785 652 653 100 100 804 804 42 591
616 615 577 561 743 100 99 100 784 785 133 67 66 684 685 685 100 70 79 137 559
544 583 587 579 457 561 782 98 99 100 99 100 720 654 652 653 685 102 6 143 64
423 492 583 587 588 579 512 561 782 100 720 98 99 100 684 653 684 685 142 114 79
746 494 779 524 555 450 588 544 561 720 742 743 782 70 71 684 653 685 46 783 102
903 904 905 495 587 484 555 616 460 581 520 425 561 102 6 71 685 66 14 815 70
935 936 937 559 715 524 587 617 492 615 417 618 465 711 102 111 43 79 143 100 102
967 968 969 64 65 495 417 717 460 583 424 429 560 685 100 932 932 102 103 742 655
100 292 273 275 267 559 459 492 494 779 746 560 64 100 133 70 15 100 591 520 544
816 817 230 403 303 65 748 560 64 64 64 65 100 784 785 142 103 655 451 417 618
848 849 782 230 265 100 784 785 100 720 70 71 782 70 82 143 591 459 614 456 586
