1c1d8a1f
21 25
71 136 6 111 111 167 102 6 6 167 163 163 14 27 87 509 510 477 509 510 476 475 476 475 475
6 6 103 976 942 977 70 6 6 932 932 70 6 79 71 123 84 86 477 478 87 26 23 477 477
6 6 71 973 974 975 142 103 102 111 111 167 104 6 111 2 66 67 23 20 976 942 977 21 477
6 6 143 1005 1006 1007 47 55 56 98 99 119 136 103 55 124 208 273 205 768 973 974 975 66 125
114 111 103 198 271 99 67 29 573 54 53 124 47 57 478 122 98 230 201 269 1005 1006 1007 98 23
116 118 197 933 933 932 99 93 477 476 476 476 54 125 509 478 56 197 144 401 273 369 67 74 134
477 478 58 144 231 196 53 477 509 510 477 478 477 478 477 478 573 54 300 306 305 231 99 108 38
510 89 87 34 34 34 85 86 475 476 509 510 475 476 509 476 476 476 52 66 98 807 808 809 102
22 70 71 300 306 209 98 66 21 476 476 476 477 478 477 478 477 478 20 66 66 839 840 841 66
82 114 103 66 66 66 66 99 66 123 476 87 509 510 477 476 476 476 52 66 66 871 872 873 66
103 782 631 34 34 630 782 782 298 217 214 205 23 477 509 510 509 510 220 119 66 66 396 66 66
98 596 598 720 782 599 539 630 98 236 307 235 99 125 475 477 478 476 477 478 56 162 230 209 591
570 629 100 782 100 784 785 600 782 99 67 99 298 217 637 509 477 476 476 476 478 56 66 752 417
782 130 720 100 784 785 100 628 597 784 785 66 99 234 232 575 509 477 509 510 669 214 209 559 456
783 815 100 782 720 782 784 785 600 815 783 99 67 66 236 279 89 509 510 479 433 231 99 64 495
783 976 942 977 782 100 782 720 599 630 815 720 66 99 202 330 299 125 87 216 301 836 900 206 559
815 973 974 975 782 782 100 816 817 628 597 783 99 99 234 695 597 600 680 776 777 67 198 176 64
720 1005 1006 1007 67 163 782 848 849 815 664 815 782 631 34 598 599 635 630 626 690 658 230 401 273
784 785 361 784 785 67 782 98 815 100 628 538 570 598 782 66 67 67 628 597 495 481 497 230 305
783 98 720 100 782 99 782 100 100 98 782 783 66 720 66 784 785 99 66 632 559 549 617 561 742
815 782 100 782 67 720 100 782 784 785 100 815 782 66 782 67 782 720 98 601 591 523 520 513 613
