1c1d1e1f
10 15
652 653 783 782 720 130 684 685 654 652 653 626 746 779 524
67 132 815 98 782 70 15 75 130 163 163 64 64 652 559
782 100 132 784 785 142 103 720 130 131 163 130 685 804 64
100 720 164 132 782 46 782 163 804 684 685 130 131 132 900
75 782 162 782 98 782 720 130 684 653 783 684 685 14 720
73 141 816 881 882 817 395 685 720 815 815 720 70 103 100
111 167 944 814 913 914 292 390 130 782 685 70 143 685 66
784 785 162 944 945 946 782 119 59 56 804 167 173 100 162
132 720 816 817 782 66 163 123 478 122 782 133 720 162 782
132 132 848 849 198 263 267 27 510 28 75 782 162 162 66
