1c1d1e1f
18 15
653 685 100 102 38 103 684 653 142 143 685 559 747 779 714
203 132 266 267 46 99 99 99 102 6 71 782 807 808 809
241 100 264 201 100 782 98 99 99 102 103 99 839 840 841
237 900 300 301 164 98 99 100 720 208 327 203 871 872 873
99 163 642 99 163 130 133 99 99 99 236 201 269 366 367
739 640 14 720 99 640 99 99 99 99 98 300 304 328 272
79 79 143 99 642 98 99 99 99 655 750 749 750 234 304
38 111 103 782 800 130 66 132 626 746 719 559 714 650 745
103 782 99 99 720 674 66 711 679 64 65 652 679 652 653
785 99 99 720 99 228 672 677 65 99 99 99 684 685 99
630 99 99 67 99 782 99 99 99 171 198 205 99 99 99
599 538 630 98 99 99 99 99 202 262 338 398 596 571 570
785 99 628 630 100 131 98 782 302 233 304 695 598 99 99
99 720 99 599 630 100 99 268 391 695 570 629 99 99 99
785 932 99 99 628 603 571 34 34 598 99 932 99 932 112
99 783 932 99 99 600 99 234 325 203 99 99 14 99 70
782 784 785 720 99 2 99 782 298 235 99 932 42 932 142
70 71 140 75 99 600 99 99 816 817 99 70 38 82 105
