1c1d1e1f
15 20
132 132 132 132 102 38 103 142 71 775 777 142 38 103 132 676 132 132 132 132
99 932 132 132 801 142 71 142 103 64 132 102 103 782 804 705 132 132 932 132
100 132 164 677 229 142 38 103 749 750 14 782 14 132 132 228 771 674 132 132
903 904 905 98 99 102 103 749 618 496 142 82 103 132 132 132 132 228 738 132
935 936 937 98 99 99 680 559 623 560 142 103 14 132 782 783 782 132 132 70
967 968 969 98 100 655 657 932 751 64 102 82 103 720 720 815 881 882 70 103
71 300 325 203 493 459 581 545 497 132 70 103 782 784 785 880 913 946 142 71
113 71 234 299 493 616 779 424 560 98 46 782 816 817 932 944 946 132 142 6
38 143 99 100 626 780 568 751 64 132 132 720 848 849 816 817 720 132 102 38
110 173 99 782 679 64 664 64 132 132 132 782 784 785 848 849 132 132 720 168
66 99 782 782 64 66 2 66 66 132 742 132 782 720 815 132 132 132 132 136
625 99 720 66 66 66 601 66 66 352 613 625 742 132 132 132 851 852 853 46
513 497 711 743 66 596 598 66 384 747 613 617 581 750 132 132 883 884 885 132
386 494 613 491 561 633 66 591 355 932 495 545 353 657 132 132 915 916 917 132
560 932 495 487 657 697 752 523 519 545 583 424 614 513 561 132 132 132 132 132
