1c1d1e1f
10 15
81 720 782 67 736 292 275 269 392 304 235 816 817 67 720
103 784 785 720 641 131 230 433 176 130 782 848 849 44 79
720 67 816 817 163 643 162 230 231 705 67 720 67 783 102
67 720 848 849 98 782 645 14 100 228 768 67 782 815 67
720 67 782 772 67 162 677 113 79 71 737 720 782 98 782
783 720 675 229 98 130 736 102 6 6 45 720 67 782 67
815 67 736 130 196 675 229 70 111 103 67 783 782 784 785
720 782 645 162 99 14 70 143 132 720 782 816 817 67 782
67 720 783 643 720 142 6 103 782 783 132 848 849 782 67
720 132 815 99 641 102 6 71 782 815 720 132 98 782 67
