1c1de31f
10 15
523 544 429 429 429 779 524 423 560 685 236 433 433 145 433
523 616 460 492 496 679 559 558 687 163 198 433 295 304 301
587 617 492 460 592 64 64 652 653 131 230 231 782 557 497
495 545 460 592 720 66 782 70 71 206 395 163 680 618 779
495 522 592 720 66 782 720 102 81 230 231 720 557 528 652
583 746 593 784 785 70 71 66 112 45 720 493 491 465 591
496 720 67 67 112 114 103 782 46 98 163 431 587 545 583
528 67 720 782 67 782 654 557 497 680 745 626 525 616 779
496 162 131 782 67 684 493 523 578 544 561 591 481 465 654
560 70 15 131 720 711 431 525 587 422 465 495 425 528 626
