4500b847
26 26
457 457 457 457 457 457 457 521 679 102 98 103 102 198 199 206 206 460 458 458 459 461 806 199 268 269
458 458 516 564 516 458 492 525 711 134 135 134 204 724 724 724 724 724 724 724 723 724 724 724 726 724
692 629 580 596 580 473 697 491 679 67 866 102 264 724 724 724 724 724 724 724 724 724 724 724 724 724
692 569 598 598 598 601 694 490 711 67 928 67 144 724 724 724 724 726 724 723 724 724 724 724 724 726
692 661 663 598 664 662 694 491 679 67 896 834 230 726 724 724 231 230 460 458 461 838 177 724 724 724
692 693 661 600 662 694 694 523 711 837 809 810 491 735 724 724 490 807 837 808 836 67 208 724 724 724
584 518 693 694 694 518 459 585 711 809 779 780 490 732 724 724 523 869 809 810 840 832 490 735 724 724
710 550 484 486 485 549 678 646 743 779 967 968 490 732 724 724 491 780 745 810 810 809 523 732 724 724
779 490 732 726 724 490 780 810 808 749 747 749 491 732 723 724 523 747 841 842 808 779 491 722 724 723
967 490 732 724 724 490 747 842 779 780 777 746 523 722 724 723 491 772 801 778 842 749 523 732 723 724
747 523 732 723 724 584 458 459 458 459 458 459 585 732 723 724 523 776 67 805 840 810 522 767 724 726
777 491 732 724 724 724 726 723 724 723 724 723 724 724 724 726 522 839 103 67 896 800 274 724 724 724
842 523 732 724 724 724 724 724 723 724 724 724 723 724 724 724 199 135 102 103 928 67 296 724 724 724
800 491 732 724 726 724 724 723 724 723 724 723 724 726 724 724 307 135 102 101 928 102 302 724 724 724
102 522 767 724 724 584 458 459 458 459 458 459 458 459 458 458 461 775 134 67 928 134 236 724 726 724
134 135 238 230 231 135 135 896 809 749 747 836 67 67 102 98 98 103 67 835 808 834 490 735 724 724
834 866 866 866 833 834 866 864 809 746 810 840 832 67 134 135 134 135 67 864 809 810 491 722 724 724
808 840 808 810 840 808 809 809 779 780 842 778 874 834 866 866 837 832 837 809 905 905 523 732 724 724
802 805 905 842 800 803 905 779 967 747 940 905 841 745 810 875 809 810 808 842 802 801 491 722 724 723
67 67 805 802 102 103 805 749 968 780 810 874 905 841 778 810 779 780 810 800 67 102 522 767 724 724
269 67 134 101 268 269 206 584 458 459 458 459 458 459 458 459 458 458 458 461 806 199 274 724 724 724
724 273 199 198 724 724 724 724 724 724 724 724 724 724 723 724 724 726 724 723 724 724 724 724 724 724
724 724 726 724 724 726 724 724 724 724 723 726 724 724 724 724 724 723 724 724 724 724 724 726 724 724
724 724 724 726 724 724 724 726 724 724 724 724 724 726 723 724 724 724 726 724 724 724 724 724 724 724
724 724 724 724 724 724 724 584 458 459 458 459 458 459 458 459 458 459 458 461 700 724 724 724 724 726
726 724 724 724 724 724 724 205 103 801 841 842 779 967 747 749 747 834 67 67 230 724 724 724 724 724
