45004647
32 32
67 674 67 680 552 458 458 516 462 564 458 516 462 492 493 494 458 461 484 485 460 458 458 458 553 679 102 130 98 98 98 98
67 642 43 712 491 502 516 548 501 596 500 548 516 630 491 65 198 731 724 724 731 756 199 103 491 711 134 162 98 98 98 98
705 6 39 712 523 503 548 501 631 598 632 630 548 469 491 96 724 544 734 726 544 734 231 101 557 494 458 458 458 553 615 102
769 40 7 680 523 503 629 631 598 598 598 632 630 601 491 732 726 576 766 724 576 766 199 103 491 695 696 696 696 491 679 134
644 38 39 712 523 503 661 600 600 600 600 600 662 601 522 767 724 544 734 724 544 734 726 199 522 692 694 1 692 491 711 102
672 134 103 680 523 534 600 600 600 600 600 600 600 662 697 724 724 576 766 724 576 766 724 724 696 693 693 696 693 491 711 134
642 102 135 712 523 692 451 693 693 693 693 694 451 693 491 735 724 544 734 724 544 734 724 724 490 692 1 692 693 491 679 102
135 616 552 458 458 458 458 461 692 693 460 458 458 458 585 767 724 576 766 724 576 766 726 307 491 692 696 693 694 491 711 134
103 680 523 65 103 102 198 756 724 726 731 756 727 728 788 788 788 307 301 791 788 231 230 199 491 692 693 1 692 491 679 67
135 712 523 65 98 198 726 724 724 724 724 790 552 458 458 458 458 458 458 458 458 458 553 735 491 692 693 696 694 491 711 67
103 680 523 160 145 724 724 788 724 726 724 231 491 695 697 696 697 697 696 697 696 697 491 733 557 461 692 460 492 525 679 67
135 712 523 732 724 724 231 163 230 724 726 199 584 458 458 458 458 458 458 458 553 692 491 733 491 695 694 696 696 491 711 100
134 680 523 732 726 231 101 67 100 230 231 230 757 757 728 727 728 757 731 199 491 692 491 732 491 692 1 692 694 491 679 102
98 712 523 732 724 199 198 199 552 458 458 458 458 458 458 458 458 553 735 307 491 692 491 733 491 692 696 693 693 491 711 134
674 680 523 128 231 230 788 792 491 695 696 697 697 696 697 697 697 491 732 199 491 692 491 733 584 458 622 692 588 525 679 67
640 712 584 458 492 493 494 458 458 458 458 458 458 458 458 458 458 585 767 790 491 692 491 128 199 274 145 724 275 491 711 102
43 744 646 646 648 491 65 130 198 756 757 757 757 757 757 756 727 757 788 231 491 692 491 256 724 724 724 726 231 491 679 134
4 7 102 103 712 491 160 145 724 790 552 458 458 458 458 458 458 458 458 458 585 692 522 288 726 724 724 231 101 491 711 67
38 39 672 552 458 458 458 553 129 790 491 695 696 697 696 697 696 697 696 696 697 693 696 137 230 788 724 199 135 491 679 67
672 135 642 491 695 696 696 522 97 790 584 458 458 458 458 458 458 458 553 692 693 694 557 494 458 518 735 518 458 585 711 67
642 136 674 491 692 1 692 696 724 724 731 199 274 756 145 756 199 103 491 692 694 693 491 678 646 550 515 549 710 646 743 102
102 135 642 491 692 696 694 490 735 724 724 724 724 724 788 788 176 135 491 692 693 694 491 64 102 198 231 98 6 7 6 7
135 705 6 491 692 694 694 491 128 724 726 724 724 790 552 458 458 492 525 692 693 693 491 32 43 230 199 9 4 4 4 4
67 769 40 491 692 1 692 491 65 230 724 724 726 231 491 647 646 646 491 692 693 693 491 64 38 7 230 209 38 39 38 39
67 705 38 491 692 696 694 557 494 458 518 735 790 518 585 711 102 103 491 692 693 693 491 64 67 11 135 134 98 135 706 675
7 136 672 491 692 694 694 491 678 646 550 484 485 549 710 743 134 675 491 692 693 693 491 32 102 770 673 674 770 677 137 132
36 7 705 584 458 458 458 585 64 102 198 401 401 145 199 770 675 137 491 692 693 693 491 64 673 137 132 136 673 674 770 673
4 39 769 649 650 651 652 653 709 672 230 177 401 401 231 641 137 675 584 458 458 458 585 709 137 43 98 104 643 137 103 67
39 104 642 681 682 683 684 685 64 136 672 198 401 231 135 675 103 704 649 650 651 652 653 64 6 4 10 8 673 740 741 673
674 640 6 713 714 715 716 717 32 135 640 230 401 199 103 643 135 704 681 682 683 684 685 32 38 42 39 101 704 641 67 675
644 672 38 713 714 715 716 717 32 103 674 208 401 231 135 675 134 641 713 714 715 716 717 709 676 770 134 135 704 135 643 643
672 136 672 713 714 715 716 717 709 672 644 198 231 135 675 67 102 675 713 714 715 716 717 32 98 103 672 675 137 103 675 137
