1800481a
28 22
522 426 426 426 426 426 426 426 484 614 609 583 955 956 957 583 614 609 484 430 426 484
554 787 786 786 786 786 786 786 491 953 954 615 987 988 989 615 953 954 491 787 1 491
554 784 785 785 785 785 785 785 459 985 986 775 985 986 1015 775 985 986 459 784 786 459
554 784 484 464 784 484 784 785 491 787 786 548 656 419 624 779 818 786 491 784 1 491
484 784 459 787 785 459 784 785 459 784 656 595 688 627 689 595 657 785 459 784 786 459
742 451 459 784 785 459 784 785 491 784 688 690 691 627 690 691 689 785 491 784 1 491
615 451 491 784 785 459 784 785 583 784 785 688 689 625 688 689 785 785 583 784 786 583
775 451 491 784 785 459 452 453 615 583 784 785 688 627 689 785 785 583 615 452 453 615
710 666 554 784 785 459 787 786 775 615 452 454 454 454 454 454 453 615 775 452 453 775
665 730 554 784 785 459 784 785 548 775 452 454 454 454 454 454 453 775 779 818 786 548
724 522 553 784 492 493 784 785 785 548 818 786 786 786 786 786 786 548 754 785 785 785
790 554 787 785 786 459 784 785 785 785 785 785 785 785 785 785 785 785 719 784 719 784
790 586 784 1 784 525 426 484 784 785 484 430 426 426 426 426 521 784 783 754 783 754
790 554 784 786 785 459 867 810 784 785 810 867 866 866 866 866 491 784 785 785 785 785
794 554 784 785 785 459 787 548 754 785 548 818 786 786 786 786 525 426 426 426 426 521
98 554 784 484 433 493 784 785 785 785 785 785 785 785 785 785 484 867 866 866 866 459
130 586 451 615 614 552 426 484 784 785 484 430 426 521 784 785 810 787 786 786 786 459
224 586 483 647 896 608 609 615 784 785 615 614 609 491 784 785 548 754 785 785 785 491
224 554 823 870 824 897 898 647 452 453 647 896 898 491 784 785 785 785 785 785 785 491
130 554 820 822 821 824 825 870 824 825 870 824 825 525 426 426 426 426 521 784 785 491
162 484 430 521 820 821 822 719 820 719 820 822 821 459 614 640 641 609 321 784 785 491
224 742 614 459 820 821 821 813 858 813 858 821 419 459 896 672 673 484 354 784 785 491
130 615 896 484 430 426 426 426 484 430 426 426 426 484 963 739 740 810 386 754 785 491
162 775 963 742 614 640 641 609 742 614 640 641 609 742 2 761 760 421 422 785 785 491
762 710 107 615 896 672 673 898 615 896 672 673 898 615 2 729 790 422 422 785 785 491
724 665 762 775 963 739 740 737 775 963 739 740 737 775 34 729 790 422 484 430 426 553
724 724 730 710 194 195 194 224 710 224 224 194 195 710 761 724 790 484 742 614 640 641
724 724 724 665 756 665 756 665 756 756 665 665 665 756 724 724 730 742 615 896 672 673
