1800481a
10 15
426 484 784 719 784 785 719 784 484 452 454 454 454 453 459
866 810 784 783 754 785 783 754 459 452 454 454 454 453 459
786 548 754 785 785 785 785 785 484 452 454 454 454 453 484
785 785 785 719 784 785 719 784 810 787 786 786 786 786 810
785 785 785 783 754 785 783 754 548 754 785 785 785 785 548
785 785 785 785 785 785 785 785 785 785 785 785 785 785 785
426 521 784 785 785 785 785 785 785 522 426 426 426 426 484
609 484 430 426 426 426 426 426 426 484 614 640 641 609 742
898 742 614 640 641 609 640 641 609 742 896 672 673 898 615
737 615 896 672 673 898 672 673 898 615 963 739 740 737 775
