66006768
32 23
880 880 880 880 880 880 787 6 632 943 880 880 881 783 600 783 600 847 815 816 720 600 783
880 880 880 880 880 880 976 631 598 975 880 880 819 631 598 783 600 879 938 939 940 599 630
975 778 779 780 975 819 6 600 943 847 880 880 784 600 783 631 598 785 970 971 972 785 600
785 810 811 812 114 815 816 600 975 880 880 880 631 598 847 599 630 817 1002 1003 1004 817 600
817 842 843 844 130 102 631 598 6 975 880 976 632 943 880 944 599 630 596 34 630 631 598
103 130 331 130 130 631 598 784 103 102 975 631 598 975 975 976 783 599 629 331 599 605 6
71 943 944 834 130 600 785 943 944 70 783 600 6 783 103 110 110 47 70 71 783 599 630
103 975 976 641 784 632 817 975 976 102 784 600 783 103 130 943 723 944 102 778 779 780 599
162 672 706 801 631 598 815 816 801 864 102 2 390 130 847 879 880 881 130 810 811 812 722
944 130 855 856 600 943 944 784 990 990 784 600 943 848 880 880 880 881 783 842 843 844 720
976 784 130 174 601 975 976 70 943 944 631 598 879 880 880 818 975 976 103 783 331 722 723
674 801 926 70 600 785 815 816 975 976 632 783 975 976 976 6 784 103 70 815 816 879 880
849 990 783 631 598 817 102 943 785 944 599 630 943 944 130 102 103 130 784 70 943 847 880
976 136 631 598 784 865 926 879 880 881 785 632 975 976 130 943 944 815 816 102 975 880 880
631 574 598 816 801 224 784 975 912 976 817 599 630 110 130 975 976 102 103 943 848 880 880
598 943 943 944 990 784 943 944 6 640 783 102 599 630 785 130 815 816 130 975 880 880 880
786 847 847 880 849 70 975 976 642 783 70 943 944 600 817 130 672 783 784 102 975 912 912
751 880 880 880 881 944 783 804 943 848 849 975 976 600 783 641 642 192 103 783 631 574 573
944 975 880 880 880 881 113 331 879 880 880 849 631 598 943 944 944 784 82 631 598 943 944
976 130 975 976 912 976 395 783 879 880 880 881 600 943 847 880 976 631 34 598 784 975 976
130 943 944 783 804 208 293 783 975 976 879 881 600 975 880 881 631 598 81 784 785 706 865
783 975 976 784 396 783 943 944 865 800 975 976 600 783 975 976 632 786 944 102 817 769 798
672 801 864 804 293 131 975 976 990 990 672 677 599 630 572 631 598 778 779 780 102 785 771
597 73 990 672 395 98 66 67 804 785 784 815 784 599 606 598 103 810 811 812 130 817 801
599 570 630 73 366 367 801 864 361 817 740 57 52 631 598 815 816 842 843 844 130 113 966
785 166 599 571 34 630 990 990 784 47 53 212 244 340 54 57 52 783 331 783 70 785 769
817 134 783 642 331 599 570 630 71 783 221 244 213 245 245 212 20 815 816 113 783 817 803
641 642 71 134 135 784 102 600 103 47 85 276 245 20 216 23 52 53 214 943 944 865 993
70 82 6 6 167 133 132 600 943 944 70 221 276 52 815 816 21 277 54 975 976 990 944
6 6 6 169 943 943 944 664 975 976 784 632 21 276 52 248 55 212 26 847 944 847 880
6 38 38 109 879 848 881 599 630 783 631 598 783 216 21 254 255 20 943 880 880 880 880
38 6 143 783 818 912 976 6 600 47 632 943 944 943 848 848 848 848 847 880 880 880 880
