66006768
22 32
512 429 460 464 916 559 545 748 544 428 428 460 551 576 460 492 428 428 428 428 428 428 428 492 917 798 853 130 66 132 133 67
587 512 429 919 822 559 558 463 423 551 544 551 515 556 576 718 492 428 428 428 428 428 492 917 798 853 198 938 939 940 941 132
525 587 512 919 256 742 685 495 616 750 455 582 587 556 556 616 492 428 428 428 428 492 917 798 853 198 337 970 971 972 973 205
559 524 587 578 514 512 915 495 617 750 619 617 749 556 556 545 460 492 428 428 428 918 798 798 821 144 337 1002 1003 1004 1005 237
685 559 525 587 588 588 578 418 717 582 619 545 582 587 556 457 429 492 428 428 428 492 947 193 854 230 177 337 337 337 231 67
685 743 559 525 524 555 416 618 428 586 587 616 428 583 619 556 512 429 492 428 428 460 917 798 798 926 99 232 297 70 135 75
493 513 883 559 525 587 547 617 586 545 748 544 492 586 587 556 556 617 718 492 428 492 949 798 853 932 209 364 365 102 932 137
66 559 545 915 690 559 587 544 464 590 559 746 615 714 748 619 556 578 616 460 492 888 921 854 198 176 133 334 335 70 38 6
132 655 616 919 926 690 559 746 592 720 720 998 559 558 495 587 556 556 617 492 919 798 798 988 296 297 165 364 365 142 6 38
591 424 429 917 802 801 864 998 803 826 751 752 672 132 559 715 587 556 544 460 918 798 798 894 334 335 98 334 335 142 38 6
559 746 917 853 855 924 860 855 924 860 102 103 131 132 132 690 559 587 422 428 429 947 798 858 234 326 268 200 241 102 38 38
679 784 990 804 795 932 66 70 79 79 815 816 796 133 132 676 741 559 746 888 718 492 947 826 99 14 230 295 235 70 6 38
783 103 66 591 545 851 795 102 103 778 779 780 513 915 824 772 674 741 690 591 616 428 917 822 112 6 71 14 778 779 780 166
787 70 71 495 456 553 616 851 641 810 811 812 559 545 947 926 131 676 673 495 544 919 320 860 163 102 6 81 810 811 812 67
881 804 103 559 587 617 717 465 801 842 843 844 655 616 919 720 14 102 719 559 746 917 858 133 133 70 6 81 842 843 844 70
881 783 203 493 525 513 615 512 979 824 331 591 424 429 884 721 784 934 76 82 719 990 932 66 795 102 114 6 71 331 70 6
753 334 335 784 559 524 555 417 717 947 826 559 549 545 947 753 865 995 136 38 103 130 131 774 513 915 824 102 6 114 103 102
719 364 365 804 71 559 587 616 428 917 894 132 559 746 884 986 856 70 38 103 130 162 719 66 559 545 947 821 46 225 795 164
71 356 235 102 836 493 715 545 492 949 822 132 783 99 990 795 66 102 103 783 783 751 784 690 655 616 919 854 591 580 545 883
103 804 395 943 944 175 559 426 460 947 766 796 132 288 591 545 851 742 689 689 796 795 690 591 616 429 917 853 495 555 616 428
198 145 231 975 976 591 555 422 428 615 580 512 883 591 416 618 615 545 883 591 517 512 883 495 617 428 979 591 555 556 512 428
401 401 199 784 591 555 556 422 428 550 524 587 578 418 618 428 748 616 615 524 555 556 578 418 717 428 615 555 556 556 556 617
