66006768
32 32
428 460 888 916 559 558 70 631 598 38 38 719 943 944 6 38 6 38 600 103 783 70 943 847 849 944 21 276 213 213 245 212
428 492 947 926 932 98 102 600 38 38 38 6 975 976 38 6 38 6 2 14 130 102 975 879 880 881 783 23 276 213 213 245
492 888 916 130 70 71 70 2 38 114 38 38 114 38 38 38 38 38 599 630 71 14 102 975 912 976 71 102 27 276 213 213
919 853 932 130 102 38 631 598 103 131 102 103 742 102 785 38 38 38 6 599 571 630 71 102 975 719 103 130 102 27 276 213
917 926 70 71 70 631 598 657 781 742 742 655 616 851 975 943 944 38 38 6 38 600 81 395 46 198 932 275 70 55 244 213
853 67 102 6 38 600 625 616 615 580 580 616 586 545 883 754 976 38 38 38 6 599 630 230 145 231 230 231 215 212 213 213
851 67 70 38 631 598 559 513 748 417 646 888 615 459 460 915 824 113 38 38 38 38 600 71 238 719 98 70 55 244 213 213
919 679 102 38 600 103 131 131 559 459 919 853 559 459 888 917 853 102 114 103 102 38 696 103 943 849 70 57 244 213 213 213
917 926 130 70 2 131 131 131 591 459 916 257 130 558 932 990 98 98 274 933 199 102 600 206 975 819 113 27 277 276 213 213
853 130 130 631 598 71 131 131 559 558 783 70 71 334 335 70 71 783 230 305 231 130 2 177 199 719 102 215 276 212 276 213
631 574 34 598 6 103 70 71 711 131 70 38 143 364 365 102 38 71 70 71 130 70 600 719 230 199 70 55 244 245 244 213
600 143 99 102 114 783 38 167 67 131 102 103 46 364 365 131 102 103 102 103 70 631 598 71 198 231 102 21 276 213 213 277
598 103 98 14 99 130 783 67 198 938 939 940 941 234 235 783 130 655 781 99 102 696 111 103 331 783 99 102 21 276 212 24
103 99 70 6 71 324 199 66 144 970 971 972 973 145 390 98 655 616 916 679 395 600 198 199 783 67 324 199 102 221 20 103
795 720 102 943 944 71 144 145 401 1002 1003 1004 1005 231 130 774 622 917 858 99 230 2 177 337 209 943 944 230 199 696 103 70
545 851 795 975 976 103 230 231 230 433 401 177 307 131 67 782 257 990 130 631 603 605 71 306 199 975 976 198 177 2 71 102
456 553 616 851 719 98 70 71 99 144 231 70 71 163 655 616 497 162 70 636 606 638 597 198 231 163 99 331 70 600 6 71
587 617 717 919 821 932 102 103 332 333 785 102 103 591 616 717 917 926 631 606 635 634 635 34 597 71 783 70 631 605 6 103
555 512 615 512 947 926 66 257 67 331 817 70 71 495 544 917 853 70 636 598 111 103 46 396 628 574 602 602 638 598 103 130
556 620 555 417 717 851 655 781 67 70 82 943 944 559 589 719 70 631 598 103 785 98 130 366 367 102 628 635 598 103 130 719
587 417 678 616 615 580 616 919 926 102 111 975 976 71 99 70 631 598 103 163 817 70 71 331 162 163 102 111 103 130 719 848
583 424 586 545 748 417 717 917 926 815 816 102 6 631 34 574 598 103 66 67 70 6 6 71 70 71 70 943 944 71 943 880
580 616 464 590 559 424 917 853 288 70 79 82 631 598 71 102 6 82 71 99 102 6 6 6 6 6 6 975 976 103 943 880
417 717 916 288 130 589 719 783 70 6 631 574 598 38 103 783 102 943 944 71 67 102 38 6 6 38 103 324 199 130 879 880
424 919 821 130 67 70 79 79 6 631 598 38 38 38 71 130 719 975 976 103 99 70 38 38 38 103 131 198 231 783 975 880
618 919 854 943 944 102 103 102 631 598 38 103 102 114 38 71 67 102 103 130 782 102 103 102 103 163 130 230 199 130 130 975
888 916 856 975 976 130 66 67 2 102 103 70 82 783 38 103 99 795 795 591 426 497 130 131 131 274 199 130 933 943 944 943
947 822 783 130 932 66 711 70 600 82 71 102 783 103 46 795 591 545 429 583 747 916 679 131 198 401 231 332 333 975 976 719
917 858 932 783 99 591 781 102 599 630 103 130 783 795 591 513 583 424 460 917 926 130 130 131 230 176 783 130 366 367 70 943
943 944 719 131 783 495 617 497 102 600 591 781 591 616 583 525 545 618 917 853 783 99 198 275 131 144 199 324 933 209 102 719
847 880 849 786 591 417 717 429 883 696 495 545 583 545 615 525 616 919 854 130 98 932 231 230 932 231 238 130 331 783 130 975
879 880 818 591 416 618 615 617 916 600 495 456 429 618 748 616 429 917 853 70 943 944 71 131 70 943 719 848 944 71 943 944
