10005612
15 23
572 875 808 806 807 460 518 522 100 419 553 484 586 192 160 161 419 585 586 512 513 578 419
573 907 1004 32 839 460 516 522 419 303 516 522 160 419 458 419 67 578 419 458 973 941 942
574 875 426 587 241 235 164 518 457 582 812 878 877 877 877 878 877 877 813 581 972 776 779
574 907 419 672 609 674 419 521 484 582 875 808 806 807 460 133 160 161 907 521 549 584 419
572 875 5 704 641 706 553 808 806 807 875 1004 32 839 460 452 457 554 908 556 814 877 878
573 907 37 553 516 548 516 840 32 839 907 585 452 484 864 744 936 806 974 424 937 938 939
574 908 362 395 516 452 518 452 452 582 908 419 164 516 896 897 968 32 839 460 969 970 971
572 363 394 317 521 516 452 452 484 484 457 139 419 164 484 452 518 484 516 516 484 518 516
572 363 317 317 521 452 484 484 516 452 580 135 206 196 808 806 810 865 866 460 452 484 516
573 363 352 317 518 484 516 165 164 586 876 516 484 518 840 32 842 897 898 460 484 516 518
574 875 364 396 484 489 522 578 419 5 875 585 452 580 484 452 452 484 516 452 452 484 516
572 875 553 452 336 419 226 940 941 942 907 419 519 876 550 452 864 865 866 460 743 744 747
573 907 452 522 678 615 680 972 997 779 908 132 165 875 521 484 896 897 898 460 775 776 779
574 875 484 582 710 647 712 271 516 518 548 452 143 907 585 580 518 484 452 452 452 484 516
574 907 516 452 548 484 548 452 452 484 516 518 133 844 877 878 877 878 877 878 877 877 878
