10005612
19 26
740 741 742 523 419 675 612 677 132 484 743 744 747 424 484 484 484 484 484 489 484 484 484 484 484 484
772 773 774 460 554 707 644 709 271 484 775 997 779 460 484 484 489 489 165 161 585 580 580 580 484 484
553 484 548 484 452 548 428 428 489 516 548 452 548 484 452 522 663 664 9 911 912 910 911 912 422 484
743 744 738 741 742 523 678 615 680 234 238 228 302 302 795 855 826 860 660 725 726 724 725 726 585 484
775 997 770 773 774 487 710 647 712 161 136 208 795 855 826 827 859 826 827 826 827 826 827 826 664 335
548 452 548 484 428 489 457 548 143 136 797 855 826 827 858 857 825 858 859 858 859 858 859 825 860 664
452 484 452 165 161 257 585 586 161 236 856 826 827 827 822 165 164 824 826 827 827 826 764 173 765 825
484 452 582 675 612 677 672 609 674 236 763 858 859 859 822 209 196 856 858 859 859 822 171 128 168 240
518 484 522 707 644 709 704 641 706 174 795 826 827 826 827 855 823 826 827 826 827 854 139 578 136 206
452 516 518 420 555 548 555 427 200 797 826 858 859 858 859 857 826 858 859 858 859 858 796 206 797 855
743 744 747 161 164 489 522 128 232 637 827 826 827 826 764 238 765 826 826 827 826 827 826 855 826 827
775 997 779 672 609 674 521 554 161 631 859 858 859 858 796 201 170 824 858 859 858 859 826 827 858 859
518 484 554 704 641 706 521 580 457 133 629 858 826 827 854 199 132 856 826 827 826 827 858 859 858 859
164 580 580 520 428 420 586 909 335 586 225 911 912 813 633 823 855 826 827 859 858 859 825 826 762 763
911 912 910 911 912 910 911 912 43 161 419 67 35 911 912 813 829 858 859 858 511 764 166 740 741 742
77 419 67 36 39 107 419 67 225 225 419 66 225 106 100 911 912 910 911 912 335 171 168 772 773 774
110 5 419 419 66 225 225 225 419 419 67 225 419 66 225 34 36 110 78 14 225 419 419 266 267 225
106 107 225 225 419 66 225 192 225 225 225 419 67 161 225 225 225 42 78 5 419 67 132 207 205 225
225 419 13 5 225 225 225 225 419 66 225 225 192 225 225 132 133 419 106 107 160 194 229 228 231 257
