91009293
26 25
180 180 180 180 250 53 720 270 401 241 690 230 231 684 685 559 746 888 884 858 100 162 163 774 714
180 180 180 180 250 53 752 230 271 116 21 21 21 21 23 21 21 21 21 21 21 21 21 21 21
180 180 180 180 250 53 793 689 238 53 223 222 594 223 222 222 191 594 223 191 126 191 126 191 191
180 180 180 180 250 53 854 684 685 85 254 276 596 246 1 246 278 596 220 314 252 2 220 315 252
315 180 314 282 284 85 854 268 274 53 319 252 596 248 278 1 247 596 318 180 285 34 350 180 250
813 214 813 22 24 149 854 270 401 85 319 317 596 248 244 278 1 596 318 180 180 181 180 180 250
845 340 845 154 122 187 853 230 271 813 319 317 691 563 564 248 661 630 286 180 180 180 180 180 285
273 305 263 272 269 70 71 775 396 845 351 313 282 282 282 282 252 663 599 563 566 214 565 563 563
176 775 230 401 401 147 146 145 401 253 180 180 180 180 180 180 250 627 254 181 181 180 181 181 253
231 100 775 230 177 401 401 401 401 285 180 180 180 180 180 180 250 282 250 180 180 180 180 180 250
199 775 775 100 775 144 233 294 401 813 220 315 180 180 180 314 284 594 318 180 180 180 180 180 250
305 337 273 199 198 401 241 775 238 53 726 563 563 213 661 563 597 662 318 180 180 180 180 180 250
116 21 21 21 21 21 117 794 133 53 220 252 181 180 181 251 252 596 318 180 180 180 180 180 250
53 220 282 282 282 252 53 854 775 85 351 284 180 180 180 283 284 596 351 282 282 282 282 282 284
85 318 180 55 213 250 85 854 70 53 726 566 220 252 565 563 563 563 563 563 563 563 563 563 563
53 318 180 54 182 250 53 854 102 85 220 282 282 282 282 282 282 282 282 282 282 282 282 282 315
85 351 315 180 314 284 53 854 775 53 726 563 563 563 563 563 563 563 566 351 284 565 563 563 563
148 21 21 214 22 21 149 854 70 85 220 281 282 282 282 282 282 282 315 180 180 253 276 253 276
186 122 187 340 186 122 187 853 142 53 319 317 180 180 180 180 180 180 180 180 180 316 282 249 315
775 133 198 305 273 275 269 775 46 85 351 284 180 180 180 180 180 180 180 180 180 285 276 285 276
775 775 396 775 230 401 401 199 775 148 21 21 23 20 813 213 180 813 24 21 21 21 21 21 23
775 198 401 273 209 230 401 401 199 186 122 186 122 187 845 213 180 845 154 186 186 122 186 122 187
208 305 305 176 775 775 230 401 401 273 337 273 273 199 847 341 310 815 860 198 337 261 112 80 198
71 775 775 270 275 269 775 144 401 176 775 270 401 401 337 401 401 145 337 369 775 270 147 146 401
38 71 775 270 401 433 273 401 401 401 273 401 401 271 775 296 401 231 775 238 198 401 401 401 401
38 775 198 401 401 401 433 401 401 401 401 401 401 401 209 302 401 199 198 337 305 401 401 401 401
