8e00c990
32 31
19 19 19 19 232 7 233 19 19 19 19 19 19 139 161 161 161 140 19 19 19 19 19 19 232 7 233 19 19 19 19
19 19 19 19 160 7 166 19 19 19 19 19 19 232 333 12 193 233 19 19 19 19 19 19 160 7 166 19 19 19 19
19 19 19 19 192 45 197 19 19 139 161 69 172 160 8 43 8 166 171 69 69 140 19 19 192 45 197 19 19 19 19
19 19 19 19 192 45 197 19 19 264 333 101 101 330 7 6 5 330 333 101 101 265 19 19 192 45 197 19 19 19 19
19 19 19 139 330 45 330 171 172 232 8 6 6 362 74 75 76 362 8 6 6 233 171 172 330 45 330 140 19 19 19
19 19 19 264 362 45 362 333 101 264 7 107 107 394 6 6 6 394 107 107 5 265 333 101 362 45 362 265 19 19 19
19 19 19 232 393 6 394 6 6 232 7 107 107 107 107 107 107 107 107 107 5 233 8 6 6 6 6 233 19 19 19
19 19 19 264 7 107 107 107 107 160 7 5 171 161 161 161 161 161 172 7 5 166 7 107 107 107 5 265 19 19 19
19 19 19 232 7 5 140 7 107 198 7 5 331 332 333 101 198 331 332 7 5 198 7 5 139 7 5 233 19 19 19
19 19 19 264 7 5 265 7 107 198 74 76 363 364 333 101 198 363 364 74 76 198 7 5 264 7 5 265 19 19 19
19 19 19 232 7 5 233 7 107 6 6 6 6 6 6 6 6 6 6 6 6 6 107 5 232 7 5 233 19 19 19
19 19 19 160 7 5 166 139 161 69 69 161 161 139 161 161 161 140 161 161 161 161 161 140 160 7 5 166 19 19 19
19 139 172 330 7 5 330 140 333 101 101 101 101 264 333 101 101 265 333 101 101 101 101 139 330 7 5 330 171 140 19
19 264 333 362 41 76 362 265 8 6 6 6 6 232 8 6 6 233 8 6 6 6 6 264 362 41 76 362 333 233 19
19 232 8 394 6 6 394 233 7 107 107 107 5 160 161 161 161 166 7 107 107 107 5 232 393 6 6 394 6 265 19
19 264 7 107 107 107 5 265 7 107 107 107 5 192 101 101 101 198 7 107 107 107 5 264 7 107 107 107 5 233 19
19 232 7 107 107 107 5 233 7 5 139 7 107 6 6 6 6 6 107 5 140 7 5 232 7 107 107 107 5 265 19
19 264 7 107 107 107 5 265 7 5 264 7 107 107 107 107 107 107 107 107 265 7 5 264 7 107 107 107 5 233 19
19 232 7 107 107 107 5 233 7 5 160 161 162 7 164 165 162 7 164 165 166 7 5 232 7 107 107 107 5 265 19
19 160 172 7 107 5 171 166 7 5 192 198 71 7 73 333 71 7 73 333 198 7 5 160 172 7 107 5 171 166 19
139 334 330 7 107 5 330 334 74 76 192 198 175 45 174 333 175 45 174 333 198 74 76 203 330 7 107 5 330 334 140
264 366 362 41 75 76 362 366 41 76 140 333 207 45 206 333 207 45 206 333 139 74 76 267 362 41 75 76 362 366 265
232 301 394 6 6 6 394 300 6 6 265 334 207 45 206 334 207 45 206 334 264 8 6 300 394 6 6 6 394 300 233
264 7 107 107 107 107 107 107 107 5 233 366 236 45 238 367 236 77 238 367 232 7 107 107 107 107 107 107 107 5 265
160 161 162 7 164 165 162 7 164 165 166 301 268 6 270 300 268 6 270 300 160 161 162 7 164 165 162 7 164 165 166
192 193 194 195 196 333 194 195 196 333 193 7 107 107 107 107 107 107 107 5 193 193 194 195 196 333 194 195 196 333 198
192 193 175 104 174 333 175 104 174 333 193 7 107 107 107 107 107 107 107 5 193 193 175 104 174 333 175 104 174 333 193
203 203 207 259 206 334 207 259 206 334 203 74 75 75 75 75 75 75 75 76 334 203 207 259 206 334 207 259 206 334 203
267 299 236 237 238 367 236 237 238 367 299 41 75 75 75 75 75 75 75 76 366 299 236 237 238 367 236 237 238 367 299
300 300 268 269 270 300 268 269 270 300 300 42 75 75 75 75 75 75 75 76 301 300 268 269 270 300 268 269 270 300 300
107 107 107 107 107 107 107 107 107 107 107 6 6 6 6 6 6 6 6 6 107 107 107 107 107 107 107 107 107 107 107
107 107 107 107 107 107 107 107 107 107 107 107 107 107 107 107 107 107 107 107 107 107 107 107 107 107 107 107 107 107 107
