01000203
10 15
684 685 807 808 809 100 100 718 100 684 685 559 715 587 576
198 205 875 840 874 99 99 70 135 141 132 652 688 431 746
270 265 842 872 843 99 70 38 38 6 71 140 141 684 685
230 231 132 99 99 99 102 103 102 6 6 103 132 132 132
14 74 82 71 99 198 205 70 77 113 103 14 132 132 132
6 82 6 103 131 144 265 142 71 102 82 6 82 77 162
111 105 6 80 163 144 231 102 103 70 38 6 105 66 162
118 70 81 66 208 176 66 198 209 102 6 38 109 781 162
26 102 114 71 66 230 273 176 132 132 102 103 119 813 162
54 76 718 113 71 66 230 231 132 53 58 55 26 66 804
