16007718
23 22
763 788 788 792 491 720 491 491 720 596 625 625 628 753 491 491 720 491 662 788 788 794
194 463 426 426 553 752 491 491 720 688 627 627 689 753 491 491 720 552 426 426 521 1
761 491 787 719 723 753 491 491 752 753 721 753 721 721 491 491 752 754 754 754 491 2
788 491 720 781 755 721 491 552 426 521 720 753 463 426 553 491 720 753 721 753 491 2
462 491 752 753 721 753 491 555 522 484 752 721 484 523 554 491 752 721 753 721 491 433
517 587 426 484 752 484 464 823 824 516 452 453 516 823 825 552 484 752 484 430 588 518
4 458 523 515 420 515 523 820 821 824 825 824 825 821 822 522 515 420 515 523 458 2
161 491 823 824 825 824 825 821 719 820 821 822 822 719 820 824 825 825 824 825 491 2
194 491 820 821 822 822 821 821 815 821 821 822 821 815 821 821 821 821 821 821 491 2
130 525 462 427 820 428 521 820 822 821 822 821 822 821 822 463 427 820 428 460 493 2
462 553 823 824 822 825 491 820 822 719 820 822 719 820 821 490 823 821 824 825 552 462
517 519 822 822 822 822 491 820 822 815 821 821 815 821 822 824 821 822 822 822 551 517
760 422 822 822 719 820 552 426 484 820 822 822 822 484 430 553 820 719 820 822 486 759
790 427 521 820 815 821 551 517 516 452 454 454 453 516 518 519 820 815 821 463 427 630
730 517 491 820 822 822 486 698 757 696 756 756 728 757 699 422 820 822 822 491 518 662
794 3 525 427 820 428 460 431 462 521 630 790 463 460 431 427 820 719 820 491 2 793
130 67 491 823 822 824 825 491 518 484 662 730 484 518 491 823 822 815 821 491 2 67
194 192 459 820 65 820 822 491 2 516 694 730 516 34 491 820 822 821 821 491 2 99
4 100 459 820 824 65 820 491 2 194 729 790 99 100 491 820 822 822 822 491 2 194
131 100 552 426 426 426 426 553 2 67 729 726 762 100 552 484 820 822 484 464 2 4
273 199 517 517 517 517 517 517 34 130 729 724 730 194 517 516 452 453 516 518 34 99
393 231 36 36 36 194 192 36 130 761 726 724 697 762 194 761 665 760 36 194 100 194
363 131 130 194 194 130 67 130 67 729 724 794 100 793 756 726 788 794 194 320 195 100
