6a006b6c
17 22
98 839 943 33 943 1006 1006 1007 1006 1007 1006 1006 1007 842 810 937 848 937 779 774 774 901
98 807 942 911 1006 900 810 901 943 1007 1006 1006 1007 807 974 912 880 913 881 911 911 839
98 776 775 934 776 777 968 842 787 819 934 820 821 841 943 976 977 978 1007 906 1007 807
71 967 967 999 967 967 1012 807 980 98 166 73 75 807 942 1008 1009 1010 1006 1006 1007 839
38 82 79 103 98 98 98 839 980 98 98 142 175 852 819 943 900 774 774 774 808 841
111 103 900 787 789 788 788 853 1012 98 98 142 73 141 44 169 839 974 911 911 911 807
802 675 839 980 98 98 99 100 1006 939 943 112 1006 939 943 107 851 942 939 939 943 839
79 45 807 980 98 67 66 67 1006 971 975 106 1006 971 975 98 44 1006 971 971 975 839
103 677 839 980 98 99 66 67 64 65 64 98 64 65 64 138 806 943 1007 1006 1007 807
673 171 905 878 879 905 774 774 774 774 905 948 67 905 774 774 774 774 943 1006 774 777
71 98 937 964 966 937 967 967 967 967 937 964 966 937 967 967 967 967 964 966 967 967
103 98 1001 64 65 1001 197 198 67 66 1001 65 64 1001 229 66 99 198 65 64 99 99
819 884 98 820 901 948 99 98 99 198 99 98 197 134 79 82 71 900 775 934 776 774
98 98 70 71 776 774 774 774 774 774 774 774 774 774 774 774 774 777 974 911 911 911
141 70 6 38 911 911 911 911 911 911 911 911 911 911 911 911 911 911 1007 1006 1006 1006
38 38 6 103 900 787 788 789 788 789 789 788 788 789 789 788 789 901 943 33 33 943
6 38 143 98 839 980 98 134 79 79 135 98 98 98 98 98 98 839 942 911 911 1006
