6a00bd6c
21 21
1013 1013 1013 1013 1013 1013 1013 1013 1013 1013 1013 1013 1013 1013 1013 1013 1013 1013 1013 1013 1013
1013 1013 1013 1013 1013 900 808 809 774 808 809 774 774 774 774 901 1013 1013 1013 1013 1013
1013 1013 1013 1013 900 777 974 807 974 906 807 974 911 911 911 776 901 1013 1013 1013 1013
1013 1013 1013 900 777 974 1 839 942 1007 838 942 1007 807 942 911 804 805 1013 1013 1013
1013 1013 900 777 974 1007 911 839 942 1007 911 1006 1007 839 943 1 842 774 901 1013 1013
1013 900 777 974 1007 776 774 777 943 1007 807 942 1007 776 774 808 841 974 776 901 1013
1013 807 974 1007 1007 911 911 911 1006 1007 839 943 1006 911 911 911 807 942 906 807 1013
1013 839 943 1006 1007 1007 939 943 1007 907 790 907 942 1007 939 943 807 942 1007 839 1013
1013 807 943 1006 1006 1007 971 975 900 1017 822 1017 778 942 971 975 838 943 1006 807 1013
1013 839 943 1007 1007 1006 1007 900 777 791 855 791 776 901 942 1006 911 1007 1007 839 1013
1013 842 810 774 775 943 907 758 906 823 880 824 906 839 907 942 939 943 1006 807 1013
1013 839 974 911 911 1007 917 839 942 976 977 978 1007 839 1017 943 971 975 1007 839 1013
1013 807 943 1006 939 943 911 776 901 792 1009 1010 900 777 974 1007 776 901 942 807 1013
1013 807 943 1007 971 975 1007 911 776 905 943 905 811 974 1007 1006 911 776 808 841 1013
1013 839 906 1007 900 775 943 1007 911 856 942 856 974 906 1007 939 943 911 911 839 1013
1013 905 757 726 777 974 1007 1006 1007 888 1007 888 776 901 942 971 975 1007 804 905 1013
1013 937 779 901 974 1007 1007 939 943 1007 939 943 1007 776 901 942 1007 900 902 937 1013
1013 920 886 905 778 943 1007 971 975 1007 971 975 1006 1007 776 725 772 905 886 920 1013
1013 920 984 937 779 901 943 1007 1007 1006 1007 1007 1007 1006 1007 900 902 937 984 920 1013
1013 952 1016 920 886 905 902 774 905 902 774 774 905 902 774 905 886 920 1016 952 1013
1013 1013 1013 920 984 937 918 950 937 918 981 950 937 918 950 937 984 920 1013 1013 1013
