6a00d76c
15 17
1006 1006 1007 1006 1007 1006 1006 1007 842 810 937 848 937 779 774 774 901
900 810 901 943 1007 1006 1006 1007 807 974 912 880 916 881 911 911 839
777 968 842 774 775 934 776 808 841 943 976 977 978 1007 906 1007 807
967 1012 807 723 724 911 723 724 807 942 1008 1009 1010 1006 1006 1007 839
98 98 839 213 1006 1006 1006 213 776 775 943 900 774 774 774 808 841
774 774 777 943 1006 1006 1006 1006 911 911 1007 839 974 911 911 911 807
939 974 911 1006 939 943 1006 1006 939 943 1007 838 942 939 939 943 839
971 975 1006 1006 971 975 1006 1006 971 975 1006 911 1006 971 971 975 839
723 756 756 756 756 724 1006 1007 723 756 724 806 943 1007 1006 1007 807
905 774 774 774 774 905 943 1007 905 774 774 774 774 878 879 774 777
937 967 967 967 967 937 964 966 937 967 967 967 967 964 966 967 967
1001 197 198 67 66 1001 65 64 1001 229 66 99 99 65 64 99 197
948 99 98 99 198 99 98 98 134 79 82 71 900 775 934 776 774
774 774 774 774 774 774 774 774 774 774 774 774 777 974 911 911 911
911 911 911 911 911 911 911 911 911 911 911 911 911 1007 1006 1006 1006
