5f006061
25 23
256 842 810 774 775 928 974 974 964 965 997 997 997 965 966 974 974 929 810 775 782 901 419
278 806 853 787 755 992 789 725 693 754 755 754 755 692 661 757 754 994 755 754 787 806 448
283 807 884 979 948 992 946 948 981 947 946 947 946 947 1011 947 979 994 979 949 978 806 420
167 844 852 845 775 746 852 1011 947 979 949 946 1013 946 947 979 948 745 782 846 852 844 452
99 870 999 871 871 743 630 631 632 908 852 980 948 742 633 634 635 741 870 871 999 871 512
203 405 658 375 405 941 662 663 664 941 964 997 966 941 665 666 667 747 375 405 659 608 489
228 229 851 278 278 972 694 695 696 972 964 965 966 972 697 698 699 972 278 278 756 544 545
247 656 883 960 761 765 963 725 755 787 755 692 755 787 755 754 961 761 765 930 883 785 547
215 752 981 992 766 767 898 884 946 979 722 715 1009 912 979 949 992 766 767 898 884 721 384
139 720 1011 907 798 893 744 852 947 849 404 747 405 688 948 978 907 798 925 907 852 881 544
99 880 979 972 964 966 972 821 946 689 313 281 278 880 946 947 972 964 998 972 821 849 416
100 688 948 787 692 661 787 788 948 817 819 818 723 816 947 946 787 693 754 787 978 881 521
203 976 908 624 912 913 915 741 624 742 624 722 915 743 624 715 1009 912 913 722 908 977 741
195 194 942 405 848 689 405 747 405 941 405 404 404 941 405 747 405 720 881 404 941 405 747
108 205 197 278 880 849 278 281 278 281 784 819 657 281 278 281 278 880 849 278 281 278 281
102 138 228 229 720 881 278 279 247 784 816 827 817 785 246 308 309 688 721 278 279 283 581
234 101 260 290 880 849 246 247 656 760 762 763 764 792 785 246 247 752 753 278 616 615 515
900 810 775 901 852 817 723 819 978 793 794 795 796 797 817 818 723 816 817 900 810 775 901
807 853 1 806 884 946 1012 788 827 825 826 827 828 829 827 947 979 949 946 806 853 1 806
806 917 754 844 821 901 908 884 946 857 858 859 860 861 1013 946 908 900 852 838 821 754 807
807 852 946 757 788 806 942 741 884 889 890 891 892 925 946 715 941 806 884 725 979 949 806
806 852 947 979 948 807 282 747 743 852 947 827 947 946 742 747 281 806 852 1011 949 948 807
813 782 812 782 812 846 278 281 941 884 946 947 946 947 941 281 279 813 812 782 781 815 846
353 404 405 405 404 405 278 279 908 852 949 946 947 979 908 279 283 405 405 404 404 404 608
101 261 262 283 278 308 309 313 941 917 948 949 946 1010 941 278 278 279 345 308 309 314 544
