33003435
32 21
401 401 199 674 134 672 740 673 38 4 5 7 769 103 67 559 524 545 429 528 559
246 433 271 136 676 103 102 103 771 38 36 39 640 98 103 685 559 746 494 592 631
245 246 401 145 199 102 135 640 43 645 38 8 676 98 98 103 134 684 653 631 598
213 245 246 401 231 135 642 67 40 7 102 131 98 135 675 676 103 67 631 598 742
213 277 312 271 100 101 672 773 38 41 135 131 135 66 132 136 674 631 598 591 522
277 212 214 231 674 131 136 705 9 5 7 131 101 134 135 134 135 601 493 524 522
245 312 401 199 640 98 131 103 66 38 39 164 631 570 597 67 631 598 591 417 618
213 245 246 401 508 198 199 98 631 539 538 35 598 43 628 35 598 67 495 549 512
213 213 245 313 310 247 246 209 600 102 103 132 6 4 7 6 7 684 559 524 587
213 213 213 245 212 212 638 35 598 103 643 98 40 39 42 42 39 103 685 559 524
213 213 213 213 245 212 216 132 98 101 677 6 39 67 67 640 643 105 135 67 559
276 213 213 213 245 312 434 199 98 135 641 38 7 103 705 105 131 66 135 631 539
212 276 213 213 213 245 246 433 209 741 673 9 4 7 136 676 105 631 538 598 742
215 283 276 213 213 277 312 231 131 103 102 103 38 42 8 135 674 600 67 591 580
336 239 217 276 277 212 124 134 135 631 539 538 35 539 538 597 631 598 132 559 523
7 98 264 282 212 212 638 565 538 598 102 103 132 103 596 635 598 903 904 905 559
932 8 270 314 244 245 26 67 642 103 134 98 98 135 632 6 720 935 936 937 778
41 208 247 244 213 122 103 769 98 98 103 162 98 103 632 782 39 967 968 969 742
39 55 244 213 277 214 209 640 135 135 642 645 134 162 628 597 100 162 331 591 580
57 244 213 277 312 231 68 508 103 769 9 7 131 130 103 632 134 804 206 495 417
244 213 277 212 214 199 397 135 134 136 676 38 7 6 7 628 539 597 396 559 491
213 277 212 312 176 238 397 103 67 67 769 6 720 4 39 164 101 3 293 559 523
213 245 212 280 231 398 135 67 102 103 705 40 782 39 135 772 102 632 778 715 524
213 213 245 124 98 135 67 102 98 98 103 38 39 772 801 102 131 628 539 597 559
213 213 213 245 56 134 67 105 98 6 7 135 677 102 103 102 131 103 67 628 538
276 213 213 213 245 54 57 56 6 720 39 101 102 98 131 135 134 135 631 538 597
212 276 213 213 213 245 212 124 38 39 164 135 134 164 104 631 539 539 598 132 628
212 212 276 213 213 213 245 212 52 660 35 539 597 631 538 598 137 938 939 940 760
212 212 244 213 213 213 277 635 634 598 206 103 628 598 103 759 760 970 971 972 726
212 244 213 213 213 277 214 199 103 102 366 367 759 757 757 788 726 1002 1003 1004 724
244 213 213 213 277 214 433 271 43 332 333 198 792 43 6 7 791 764 731 727 792
213 213 213 277 280 401 433 231 38 932 230 932 6 720 816 817 10 7 791 792 6
