33003435
26 24
720 39 38 39 38 38 720 4 39 135 641 599 630 38 7 705 720 807 808 809 807 808 809 782
39 938 939 940 756 760 38 782 7 800 675 137 601 6 41 769 804 839 840 841 839 840 841 11
822 970 971 972 726 724 821 38 39 103 137 101 3 38 39 769 238 871 872 873 871 872 873 43
726 1002 1003 1004 724 792 116 53 54 100 101 631 598 98 135 705 134 66 238 135 134 360 6 5
7 791 763 724 726 53 244 315 245 56 164 564 134 135 102 103 738 192 672 740 773 134 38 900
720 7 67 791 792 125 312 932 282 245 128 606 56 134 164 135 134 67 103 132 136 672 740 740
785 39 104 116 53 244 244 281 87 87 160 87 244 54 57 54 103 102 98 98 9 836 782 10
39 104 57 212 244 277 87 26 67 67 164 43 27 87 244 245 56 134 135 55 56 38 39 38
7 101 21 244 277 26 104 642 67 772 6 782 7 103 27 213 245 54 57 244 244 54 57 54
39 67 55 213 124 102 202 508 132 704 38 42 720 7 103 23 213 277 87 22 27 276 213 244
67 103 125 276 280 199 264 231 43 137 98 98 38 39 101 59 277 20 43 676 43 21 276 213
102 135 23 212 245 246 271 9 39 164 135 119 134 98 135 125 22 6 720 705 40 7 27 213
7 103 55 244 277 315 313 56 55 35 121 212 56 395 55 26 102 38 39 102 40 39 103 125
39 208 215 212 216 932 215 276 24 132 21 277 277 160 87 58 134 101 804 98 38 7 101 23
8 66 472 282 248 200 247 22 100 103 675 21 24 396 103 23 54 9 7 43 6 39 135 55
104 507 504 314 280 932 314 54 100 135 101 57 54 306 275 103 126 134 40 782 39 832 55 244
7 230 177 215 212 313 212 20 6 7 135 125 22 198 176 101 125 58 38 39 57 121 244 213
5 7 131 270 215 213 245 54 38 720 55 24 742 230 401 275 21 245 56 164 125 244 213 213
5 41 163 144 401 282 213 245 128 121 124 591 545 529 230 231 103 23 87 160 315 276 213 213
783 39 103 230 247 212 213 277 160 87 22 495 616 496 742 103 103 103 132 132 230 215 213 213
720 804 7 103 21 276 213 24 132 43 67 559 749 579 616 529 742 103 130 98 98 270 215 213
39 361 38 8 103 27 213 56 6 720 10 7 685 559 549 545 618 593 98 135 641 296 401 282
134 807 808 809 66 260 96 97 11 38 782 38 8 135 559 459 496 685 135 804 801 236 401 282
102 839 840 841 198 293 21 213 54 132 11 67 116 53 54 748 592 684 685 102 104 59 313 244
7 871 872 873 292 261 103 27 212 52 117 53 212 244 245 56 116 117 53 54 57 244 213 213
5 7 230 199 198 176 66 103 23 276 244 244 213 213 213 245 212 244 245 212 244 213 213 213
