16007718
19 15
491 720 753 656 596 625 625 625 625 628 657 721 753 491 465
491 720 721 596 596 625 625 625 625 628 628 753 721 491 465
491 720 753 596 596 625 625 625 625 628 628 721 753 491 465
491 720 721 596 596 625 625 625 625 628 628 753 721 491 465
491 752 721 596 688 627 627 627 627 689 628 721 753 491 465
491 720 753 688 627 627 690 691 627 627 689 753 721 491 465
587 426 619 620 426 484 561 689 484 426 619 620 426 588 465
493 512 491 491 523 516 452 453 516 523 491 491 512 525 553
491 723 491 491 723 656 595 595 657 754 491 491 723 491 523
491 720 491 491 752 596 625 625 628 753 491 491 720 491 518
491 720 491 491 720 596 625 625 628 721 491 491 720 491 662
553 752 491 491 720 688 627 627 689 753 491 491 720 552 426
754 721 491 491 752 753 721 753 721 721 491 491 752 754 754
721 721 491 552 426 521 720 753 463 426 553 491 720 753 721
721 721 491 555 522 484 752 721 484 523 554 491 752 721 753
752 484 464 823 824 516 452 453 516 823 825 552 484 752 484
420 515 523 820 821 824 825 824 825 821 822 522 515 420 515
825 824 825 821 719 820 821 822 822 719 820 824 825 825 824
822 822 821 821 815 821 821 822 821 815 821 822 821 821 821
