c100c2c3
19 15
103 170 201 201 33 3 4 4 4 5 33 201 201 171 104
1 205 175 176 65 3 4 4 4 5 65 175 176 204 1
1 205 175 176 42 3 4 4 4 5 42 175 176 204 1
1 205 113 19 21 18 50 18 50 18 50 19 21 204 1
1 205 81 51 54 116 116 84 116 116 84 51 54 204 1
1 205 81 116 84 116 84 116 116 116 84 116 84 204 1
1 205 10 10 10 33 49 84 116 33 8 10 10 204 1
1 205 68 67 67 65 82 116 116 65 68 67 67 204 1
1 205 68 67 67 42 81 84 116 42 68 67 67 204 1
1 205 113 50 18 85 86 130 131 117 17 50 18 204 1
1 205 81 84 84 160 161 162 163 164 84 84 116 204 1
1 205 81 116 84 192 193 194 195 196 84 116 116 204 1
1 205 81 19 22 224 225 226 227 228 84 19 22 204 1
1 205 81 51 54 256 257 258 259 260 116 51 54 204 1
1 202 169 169 169 173 84 116 84 172 169 169 169 203 1
1 33 34 237 292 298 49 84 116 299 295 237 32 33 1
1 65 36 269 324 325 81 116 84 326 327 269 64 65 1
1 73 68 67 332 65 81 84 116 65 300 67 67 73 1
1 105 100 288 289 73 3 4 5 73 290 291 99 105 1
