c100c2c3
26 25
1 205 276 275 174 176 176 275 276 150 151 152 153 154 155 156 276 277 174 176 176 277 276 204 1
1 205 310 307 174 236 311 307 308 182 183 184 185 186 187 188 308 309 312 236 176 309 313 204 1
1 205 342 339 174 268 343 339 308 214 214 23 24 25 220 220 308 341 344 268 176 341 345 204 1
1 205 340 65 174 176 33 65 340 74 74 55 56 57 74 74 340 65 33 176 176 65 340 204 1
1 205 81 115 17 50 65 115 54 115 118 193 194 195 119 115 54 115 65 18 50 115 54 204 1
1 205 82 84 116 84 65 22 116 84 224 225 226 227 228 84 116 84 65 22 116 84 84 204 1
1 202 169 173 49 116 115 54 84 116 256 257 258 259 260 116 84 116 115 54 84 172 169 203 1
1 33 34 205 82 84 116 84 116 84 116 84 116 84 116 84 116 84 116 84 116 204 34 33 1
1 65 66 202 169 169 169 169 173 49 84 116 84 116 84 116 172 169 169 169 169 203 66 65 1
1 74 98 33 34 32 237 292 298 173 84 84 116 84 116 172 299 295 237 32 32 33 98 74 1
1 73 170 201 201 171 269 324 296 293 49 116 84 116 84 294 297 327 269 170 201 201 171 73 1
1 105 205 175 176 204 67 332 328 325 53 84 116 84 116 326 329 300 67 205 175 176 204 105 1
1 1 205 113 18 204 69 69 74 65 3 4 4 4 5 65 74 70 69 205 113 18 204 1 1
1 1 202 169 169 203 101 101 73 74 3 4 4 4 5 74 73 102 101 202 169 169 203 1 1
1 1 33 39 40 33 1 1 105 73 3 4 4 4 5 73 105 1 1 33 39 40 33 1 1
1 1 65 71 72 65 1 1 1 105 3 4 4 4 5 105 1 1 1 65 71 72 65 1 1
1 1 73 103 170 201 201 171 1 1 3 4 4 4 5 1 1 170 201 201 171 104 73 1 1
1 1 105 1 205 175 176 204 1 1 3 4 4 4 5 1 1 205 175 176 204 1 105 1 1
1 1 1 1 205 113 18 204 1 1 3 4 4 4 5 1 1 205 113 18 204 1 1 1 1
1 1 1 1 202 169 169 203 1 1 3 4 4 4 5 1 1 202 169 169 203 1 1 1 1
1 1 1 1 33 39 40 33 1 1 3 4 4 4 5 1 1 33 39 40 33 1 1 1 1
1 1 1 1 65 71 72 65 1 1 3 4 4 4 5 1 1 65 71 72 41 1 1 1 1
1 170 201 201 171 103 170 201 201 33 3 4 4 4 5 33 201 201 171 104 170 201 201 171 1
1 205 175 176 204 1 205 175 176 65 3 4 4 4 5 65 175 176 204 1 205 175 176 204 1
1 205 113 18 204 1 205 175 176 42 3 4 4 4 5 42 175 176 204 1 205 113 18 204 1
1 202 169 169 203 1 205 113 19 21 18 50 18 50 18 50 19 21 204 1 202 169 169 203 1
