c100c2c3
27 17
1 1 205 234 166 166 166 166 166 166 166 166 166 235 204 1 1
1 1 205 234 166 166 166 166 166 166 166 166 166 235 204 1 1
1 1 205 234 166 166 166 166 166 166 166 166 166 235 204 1 1
1 1 205 266 200 200 229 230 166 232 233 200 200 267 204 1 1
1 1 202 169 169 169 261 262 200 264 265 169 169 169 203 1 1
1 1 33 34 237 292 298 169 169 169 299 295 237 32 33 1 1
1 1 65 36 269 324 325 246 247 248 326 327 269 64 65 1 1
1 1 73 68 67 332 65 278 279 280 65 300 67 67 73 1 1
1 1 105 100 288 289 73 3 4 5 73 290 291 99 105 1 1
1 1 1 1 320 321 138 3 4 5 137 322 323 1 1 1 1
1 11 133 134 135 76 113 18 50 18 50 75 133 134 135 12 1
1 43 165 166 167 108 82 116 84 116 84 107 165 166 167 44 1
1 13 197 198 199 16 81 84 116 84 116 15 197 198 199 14 1
1 45 8 76 2 48 53 116 84 116 84 48 2 75 9 46 1
1 105 100 108 113 80 128 129 130 131 132 80 18 107 100 105 1
11 133 134 135 76 49 160 161 162 163 164 84 75 133 134 135 12
43 165 166 167 108 81 192 193 194 195 196 116 107 165 166 167 44
13 197 198 199 16 82 224 225 226 227 228 84 15 197 198 199 14
45 8 76 2 48 53 256 257 258 259 260 116 48 2 75 9 46
74 206 108 113 80 84 116 84 116 84 116 84 80 18 107 206 74
73 11 133 134 135 76 49 116 84 116 84 75 133 134 135 12 73
105 43 165 166 167 108 82 84 116 84 116 107 165 166 167 44 105
1 13 197 198 199 16 81 116 84 116 84 15 197 198 199 14 1
1 45 8 76 2 48 53 84 116 84 116 48 2 75 9 46 1
1 74 239 108 113 80 84 116 84 116 84 80 18 107 239 74 1
1 73 206 139 33 81 116 84 116 84 116 116 33 140 206 73 1
1 105 1 238 41 137 138 3 4 5 137 138 41 238 1 105 1
