c100c2c3
27 17
1 1 205 81 84 84 160 161 162 163 164 84 84 116 204 1 1
1 1 205 81 116 84 192 193 194 195 196 84 116 116 204 1 1
1 1 205 81 19 22 224 225 226 227 228 84 19 22 204 1 1
1 1 205 81 51 54 256 257 258 259 260 116 51 54 204 1 1
1 1 202 169 169 169 173 84 116 84 172 169 169 169 203 1 1
1 1 33 34 237 292 298 49 84 116 299 295 237 32 33 1 1
1 1 65 36 269 324 325 81 116 84 326 327 269 64 65 1 1
1 1 73 68 67 332 65 81 84 116 65 300 67 67 73 1 1
1 1 105 100 288 289 73 3 4 5 73 290 291 99 105 1 1
1 1 1 1 320 321 138 3 4 5 137 322 323 1 1 1 1
1 11 9 10 10 76 113 18 50 18 50 75 9 10 10 12 1
1 43 113 18 50 108 82 116 84 116 84 107 113 18 50 44 1
1 13 81 116 116 16 81 84 116 84 116 15 81 116 116 14 1
1 45 8 76 49 48 53 116 84 116 84 48 53 75 9 46 1
1 105 100 108 81 80 128 129 130 131 132 80 116 107 100 105 1
11 9 10 10 76 49 160 161 162 163 164 84 75 9 10 10 12
43 113 18 50 108 81 192 193 194 195 196 116 107 113 18 50 44
13 81 116 116 16 82 224 225 226 227 228 84 15 81 116 116 14
45 8 76 49 48 53 256 257 258 259 260 116 48 53 75 9 46
74 206 108 81 80 84 116 84 116 84 116 84 80 116 107 206 74
73 11 9 10 10 76 49 116 84 116 84 75 9 10 10 12 73
105 43 113 18 50 108 82 84 116 84 116 107 113 18 50 44 105
1 13 81 116 116 16 81 116 84 116 84 15 81 116 116 14 1
1 45 8 76 49 48 53 84 116 84 116 48 53 75 9 46 1
1 74 239 108 81 80 84 116 84 116 84 80 116 107 239 74 1
1 73 206 139 33 81 116 84 116 84 116 116 33 140 206 73 1
1 105 1 238 41 137 138 3 4 5 137 138 41 238 1 105 1
