42004344
22 24
813 813 813 813 192 433 192 231 660 698 699 606 597 230 192 433 941 420 813 814 877 813 421 880
813 839 813 813 433 433 231 660 606 606 606 635 598 164 230 192 941 452 813 427 486 484 488 911
723 813 813 813 813 271 164 636 606 606 605 717 718 719 264 433 433 813 452 453 973 910 425 944
813 813 813 295 232 433 199 692 635 606 605 749 750 751 270 297 230 433 973 973 427 488 453 976
813 813 231 66 236 433 192 199 871 692 629 781 782 783 300 235 264 433 433 427 455 427 457 975
813 297 66 66 66 270 192 192 199 164 164 759 724 760 164 266 192 433 433 845 427 457 911 975
813 201 269 66 198 433 433 433 434 756 756 724 724 724 760 264 433 904 425 813 909 425 911 912
845 877 434 273 427 453 454 455 452 433 433 433 433 433 433 433 433 488 457 813 941 942 943 944
452 845 845 427 455 975 975 975 839 454 486 973 433 433 973 484 455 910 910 845 973 974 787 976
433 456 814 975 910 975 973 975 975 910 973 452 426 973 943 421 910 910 814 877 910 911 912 976
433 433 456 426 910 975 975 722 975 910 973 973 973 973 973 973 910 910 452 877 909 976 943 976
295 304 232 433 910 975 975 754 975 973 973 973 973 943 839 973 910 814 877 456 909 903 976 976
946 947 948 270 192 975 975 975 975 910 973 910 973 816 910 910 786 723 909 422 903 941 816 976
978 979 980 270 433 904 433 305 813 813 813 910 433 433 910 910 910 910 420 910 295 232 816 976
1010 1011 1012 270 433 305 231 66 270 845 845 433 433 433 910 910 910 424 910 231 66 236 976 976
66 66 198 845 231 66 66 198 845 813 813 433 433 433 910 910 816 910 297 946 947 948 270 976
66 66 230 231 66 66 198 813 877 878 305 305 433 433 433 910 192 433 303 978 979 980 270 976
66 66 66 66 66 66 230 845 909 231 66 66 230 305 305 305 305 192 265 1010 1011 1012 270 976
66 66 66 66 66 66 66 230 231 66 66 66 66 839 66 66 66 230 433 273 199 198 845 976
66 66 66 66 66 66 66 66 66 66 66 66 66 66 66 66 66 66 230 910 976 839 976 976
66 66 66 66 66 66 66 839 66 66 66 66 66 839 66 66 66 66 66 230 305 305 976 976
66 66 66 66 66 66 66 66 66 66 66 66 66 66 66 66 66 66 66 66 66 66 230 976
