7a007b7c
36 32
71 198 674 66 197 198 229 70 6 114 45 198 677 197 66 769 102 6 38 6 103 113 71 676 769 292 288 259 559 524 580 545
114 45 197 768 66 928 66 102 103 864 66 675 70 71 198 66 44 114 103 46 802 102 103 70 71 324 256 288 259 559 524 491
71 70 82 45 44 81 198 108 82 114 45 44 114 114 43 45 163 771 770 673 640 66 44 6 103 356 256 256 288 259 559 524
6 114 38 71 70 38 71 44 103 742 742 742 742 742 742 742 742 686 686 163 768 675 66 113 71 289 389 256 256 288 259 559
103 70 6 38 6 114 103 742 591 579 617 615 579 617 553 580 578 578 617 497 684 685 197 102 114 45 324 256 256 288 256 288
82 6 114 111 103 742 591 426 583 587 544 583 587 544 429 583 587 556 544 496 685 198 66 44 71 197 356 256 256 288 393 392
6 6 71 66 655 459 583 616 553 523 423 553 417 618 553 513 583 587 422 429 497 44 135 70 103 197 392 256 256 393 684 742
6 38 6 71 430 459 429 716 592 559 747 592 751 494 592 559 580 417 618 581 617 593 113 6 45 66 197 392 393 684 591 545
38 38 114 103 495 616 496 224 258 259 711 392 393 292 293 295 559 715 580 545 465 44 6 38 71 197 66 352 353 720 417 618
38 81 229 655 417 717 592 292 293 295 833 834 835 356 256 293 293 259 559 746 592 70 38 6 103 197 258 259 684 591 523 544
81 102 71 430 616 528 257 324 256 359 865 866 867 356 256 256 256 359 229 197 70 6 103 46 224 292 293 295 720 417 678 423
103 44 81 495 545 496 289 356 256 359 897 898 899 289 389 289 289 353 198 14 113 38 71 66 292 256 256 295 742 559 513 618
82 82 103 463 459 496 197 289 389 353 66 197 163 289 198 197 98 197 98 113 81 102 143 197 356 256 295 591 545 529 559 577
102 103 198 559 520 545 529 197 258 259 198 66 197 229 163 66 14 70 82 114 111 82 103 197 289 392 393 559 456 496 66 559
66 44 71 14 559 622 592 66 229 197 14 66 66 66 742 66 102 103 102 71 198 113 71 197 197 197 742 591 619 545 529 655
71 70 6 103 44 71 70 82 71 70 103 66 198 655 513 497 66 686 66 113 82 114 103 66 684 591 459 583 417 618 551 427
111 38 6 71 14 102 6 38 38 143 66 197 720 491 646 465 591 459 497 102 81 70 82 71 66 559 459 553 523 545 582 424
198 102 38 6 81 70 169 46 102 103 292 293 295 495 545 586 417 618 592 197 113 6 103 46 98 493 747 592 559 424 494 590
229 76 6 38 169 102 109 742 197 66 324 256 359 495 456 615 459 429 593 70 114 38 71 640 98 130 165 684 685 558 292 321
100 112 38 114 109 66 591 459 497 66 742 289 353 559 523 451 459 494 719 102 45 102 169 768 198 162 132 66 99 130 352 353
71 136 6 71 198 720 417 618 465 591 459 497 192 257 559 589 590 687 70 82 71 70 80 229 672 770 803 66 66 675 676 685
38 6 38 103 292 321 495 513 613 741 618 592 225 226 197 140 15 44 6 38 114 111 109 66 100 66 197 768 66 66 197 768
6 103 46 197 352 353 559 587 545 494 592 229 198 76 82 6 6 82 38 103 66 66 162 66 130 98 100 66 165 130 98 198
38 71 66 742 742 258 295 559 558 624 197 70 71 70 111 111 38 38 169 780 900 902 774 775 774 775 774 775 901 781 130 66
102 103 591 579 617 529 356 295 257 198 140 113 103 46 742 742 102 114 109 812 807 870 782 783 882 785 786 871 807 813 883 66
70 45 559 587 544 465 392 359 289 44 114 81 66 655 426 618 529 66 70 908 839 974 814 815 914 817 818 974 839 909 947 44
38 82 45 495 424 592 352 353 197 44 71 113 71 430 424 494 592 70 6 940 776 901 846 847 848 849 850 900 777 941 915 70
103 102 71 559 589 66 198 66 66 70 6 167 173 495 616 529 165 142 38 972 844 807 974 944 880 946 911 839 845 973 947 168
71 44 114 71 14 140 134 71 14 113 38 71 655 417 717 496 162 102 6 1004 876 807 943 976 977 978 1006 807 877 1005 1011 174
38 71 112 6 81 166 114 6 81 102 114 103 430 616 429 592 66 70 38 6 908 839 943 1008 1009 1010 1007 839 909 947 66 70
103 102 114 38 38 45 742 102 114 45 742 591 524 545 496 165 66 113 6 38 940 776 905 910 1006 1007 905 777 941 915 44 38
561 742 742 102 103 591 426 561 742 527 618 583 525 491 496 162 70 6 38 6 972 935 937 943 1006 1007 937 936 973 947 70 6
615 578 521 561 591 555 616 429 581 491 551 578 608 587 617 529 102 38 6 38 1004 967 969 964 965 966 970 968 1005 1011 168 38
555 556 422 551 525 619 512 492 492 583 517 556 482 555 545 496 162 102 114 6 6 103 1001 996 997 998 1002 66 66 66 112 6
587 556 616 582 524 619 556 578 617 585 416 584 588 417 618 428 497 66 66 113 38 45 66 113 6 6 45 70 71 66 136 38
524 587 512 551 525 523 588 556 512 582 616 582 523 746 492 428 496 66 162 102 103 66 70 38 38 38 79 6 38 82 38 6
