5f006061
20 23
278 198 140 198 199 167 137 231 230 534 535 536 537 538 330 331 488 486 394 395 388 389 329
198 199 172 256 192 97 129 636 637 566 567 568 569 570 638 639 453 480 489 417 513 361 362
810 774 775 901 232 173 100 668 669 598 599 600 601 602 670 671 448 513 545 740 810 774 775
951 952 953 838 352 714 257 700 701 280 215 214 215 279 702 703 544 742 640 844 951 952 959
983 984 985 661 1008 866 745 732 733 761 762 763 764 765 734 735 907 864 816 757 989 984 985
1015 1016 1017 981 1010 898 819 818 691 793 794 795 796 797 819 690 819 992 947 946 1021 1016 1017
775 774 775 852 913 898 979 949 824 825 826 827 828 829 827 948 981 992 912 947 776 775 812
870 871 896 947 849 908 1009 722 722 857 858 859 860 861 915 914 722 908 720 981 897 871 871
870 896 993 981 881 941 907 540 541 889 890 891 892 893 542 543 745 941 688 948 994 897 871
213 993 993 1012 849 281 405 572 573 372 880 824 625 373 574 575 375 281 848 978 994 994 546
260 993 993 979 721 279 278 604 605 215 688 949 948 215 606 607 278 279 688 947 994 994 214
324 993 908 949 753 908 340 341 908 746 720 949 689 907 714 310 311 908 880 979 744 994 613
257 744 864 978 817 865 278 348 941 853 979 1010 948 757 747 342 343 864 816 1010 865 742 420
289 864 993 947 979 898 691 723 757 788 947 946 947 946 787 818 819 992 947 946 995 865 609
247 993 993 979 948 898 946 948 981 1013 946 947 946 947 979 949 979 992 724 949 994 995 544
215 993 908 964 966 744 884 946 1010 916 947 946 947 979 1010 948 948 908 964 966 908 994 578
139 744 941 964 998 747 745 907 852 947 946 1013 946 947 946 741 745 942 964 998 941 744 611
203 942 972 964 966 972 907 746 884 946 947 979 949 946 947 745 907 1004 964 998 972 941 450
161 197 281 832 833 281 741 744 741 820 946 1010 948 1013 715 744 908 282 832 833 281 281 612
173 101 229 308 309 278 747 941 747 917 1013 946 980 948 747 941 941 278 314 308 309 514 515
