79007a7b
14 27
258 258 258 5 167 169 169 168 5 262 258 295 296 256 256 297 298 151 151 151 151 295 296 256 297 298 151
16 17 18 72 167 169 169 168 72 19 20 21 320 256 256 321 182 183 183 183 183 183 320 256 321 182 183
48 49 50 104 512 641 642 643 104 51 52 53 288 256 256 289 483 484 485 484 485 485 320 256 321 483 484
547 548 546 106 513 515 547 548 106 513 546 547 320 256 256 321 480 482 482 481 482 481 320 256 321 480 482
676 579 678 515 12 577 515 12 609 516 515 515 288 256 256 289 480 481 481 481 481 482 320 256 321 480 481
546 547 546 546 108 513 547 108 513 548 547 547 320 256 256 321 480 482 481 482 481 482 320 256 321 480 482
256 321 544 514 12 608 515 12 544 516 515 515 288 256 256 297 298 5 174 175 5 262 258 258 258 258 5
256 321 576 546 108 513 547 108 513 548 515 547 320 256 256 321 142 238 206 207 238 142 238 208 238 142 238
256 321 609 547 548 514 515 548 547 548 515 547 320 256 256 321 239 238 167 168 238 239 238 182 238 239 238
258 258 258 5 544 515 515 516 515 5 262 258 258 258 258 5 512 640 641 642 640 641 642 643 641 172 173
209 210 211 238 577 515 547 548 547 238 208 209 209 210 211 238 576 516 514 515 516 514 515 514 514 515 516
183 183 183 238 608 515 515 516 515 238 182 183 183 183 183 238 608 548 546 547 548 514 515 676 515 678 679
640 641 642 643 513 514 515 516 515 642 643 640 641 642 643 643 513 516 514 515 516 514 515 516 514 515 516
547 548 514 515 548 546 547 548 676 677 678 679 548 546 547 548 515 548 514 515 548 546 547 548 514 515 548
