12001314
28 21
376 376 378 378 436 437 436 377 378 376 376 458 582 545 545 545 458 820 821 822 821
376 376 378 378 378 373 377 378 378 376 376 458 646 704 705 740 491 820 1 820 1
552 426 427 583 377 346 378 583 430 427 426 553 2 3 3 4 491 820 824 822 824
704 705 737 679 452 454 453 679 646 704 705 737 34 131 162 165 583 820 583 430 426
3 3 35 711 452 454 453 711 34 3 4 761 696 696 696 762 679 451 679 646 704
762 131 132 35 729 692 730 131 130 131 761 794 162 132 130 727 711 483 711 34 761
793 696 696 696 724 660 697 696 696 696 794 99 130 162 130 793 665 697 696 696 794
620 619 618 162 729 730 162 617 620 619 620 619 620 619 619 622 727 621 620 620 620
194 194 649 622 729 730 621 650 103 761 665 696 696 696 696 696 692 762 194 321 102
130 194 224 109 729 730 102 195 109 729 794 130 99 217 218 219 729 730 321 194 321
320 321 109 699 692 730 320 321 761 730 99 194 666 249 250 251 793 730 217 218 219
130 153 154 155 793 692 665 665 692 231 100 110 230 731 697 700 130 727 249 250 251
321 185 186 187 224 729 660 692 730 224 130 99 198 730 130 130 130 729 665 730 194
130 761 231 195 103 729 692 724 730 110 131 761 692 660 665 665 665 660 660 692 762
761 692 199 130 761 697 697 697 730 130 194 729 25 26 13 18 19 853 17 18 19
692 724 692 665 794 281 282 283 793 762 110 729 57 58 45 50 51 852 49 50 51
660 660 724 730 321 313 314 315 352 727 194 230 692 660 724 660 692 660 692 692 724
17 18 19 730 194 761 724 762 384 727 110 198 17 18 14 26 27 853 20 21 24
49 50 51 724 665 697 697 697 665 692 696 692 49 50 46 58 59 852 52 53 56
697 697 692 763 730 224 194 71 729 231 130 729 724 724 724 660 724 660 692 692 724
71 67 727 194 366 367 166 224 698 194 198 692 25 26 13 18 19 853 17 18 19
103 761 730 224 292 261 130 194 224 169 729 692 57 58 45 50 51 852 49 50 51
731 660 660 762 224 366 367 102 384 761 692 692 724 692 660 724 692 660 692 692 724
17 18 19 853 199 292 261 130 761 692 692 660 17 18 14 21 24 853 25 26 27
49 50 51 852 730 130 727 130 729 692 692 692 49 50 46 53 56 852 57 58 59
697 697 697 697 692 731 692 665 724 692 692 697 697 697 697 697 697 697 697 697 697
769 768 772 77 793 692 724 724 660 724 794 76 772 773 768 769 768 769 768 769 768
801 800 804 772 71 793 697 697 697 794 76 772 804 805 801 800 801 800 801 800 801
