8800898a
25 21
18 18 18 18 18 18 18 114 114 74 75 76 114 114 18 18 18 18 18 18 18
313 470 435 435 178 408 435 435 114 74 75 76 114 408 435 435 178 408 435 469 314
345 369 8 6 142 528 529 529 173 6 6 6 143 528 529 529 141 6 6 368 346
345 369 7 5 110 177 273 273 46 5 5 5 110 177 273 273 46 5 5 368 346
409 369 7 5 338 176 240 240 338 176 240 240 338 176 240 240 338 7 5 368 410
490 371 7 5 371 176 240 240 371 176 240 240 371 176 240 240 371 7 5 371 490
552 371 7 5 406 499 176 434 373 176 240 240 406 499 176 434 373 7 5 371 552
263 371 7 5 371 564 7 560 371 176 240 240 371 564 7 560 371 7 5 371 266
295 371 7 5 371 8 5 6 371 176 240 240 371 8 5 6 371 7 5 371 298
18 371 7 5 371 7 68 7 371 176 240 240 371 7 109 5 371 7 5 371 18
18 371 7 5 371 7 6 5 371 176 240 240 371 7 5 5 371 7 5 371 18
18 371 7 5 406 498 435 435 373 176 240 240 406 498 435 435 373 7 5 371 18
18 371 7 5 371 528 529 529 371 176 240 240 371 528 529 529 371 7 5 371 18
18 371 7 5 371 177 273 273 371 176 240 240 371 177 273 273 371 7 5 371 18
18 371 7 5 371 176 109 240 371 176 240 240 371 176 68 176 371 7 5 371 18
18 371 7 5 371 176 240 240 371 176 240 240 371 176 273 240 371 7 5 371 18
18 371 7 5 406 499 176 434 373 176 240 240 406 499 176 434 373 7 5 371 18
18 371 7 5 371 564 176 560 371 176 240 240 371 564 176 560 371 7 5 371 18
313 337 7 178 472 177 240 178 472 176 240 240 464 178 176 273 464 178 7 336 314
345 369 7 142 564 176 240 141 6 5 5 5 6 142 176 240 466 141 39 368 346
345 369 7 110 177 240 240 46 5 5 5 5 5 110 176 240 273 46 5 368 346
409 500 500 500 500 500 500 500 178 74 75 76 178 344 500 500 500 500 500 500 410
490 278 279 280 490 392 393 393 114 74 75 76 114 392 393 393 490 278 279 280 490
552 226 520 174 552 399 617 618 114 74 75 76 114 619 617 398 552 226 520 174 552
263 418 552 420 266 330 18 418 114 74 75 76 114 519 18 327 263 418 552 420 266
