8800898a
21 21
114 408 435 435 178 18 18 135 588 589 589 589 589 138 18 18 178 408 435 435 178
142 528 529 529 371 18 18 167 391 198 198 198 198 170 18 18 371 528 529 529 142
110 6 6 6 371 18 135 84 177 241 273 241 273 90 138 18 371 8 6 6 110
110 5 5 5 371 18 167 116 176 240 66 208 240 122 170 18 371 7 5 5 110
178 7 5 5 371 18 199 148 208 272 273 240 272 154 202 18 371 7 5 5 178
371 7 15 7 371 18 231 167 176 240 272 272 240 170 392 18 371 7 15 7 371
371 7 47 39 371 18 263 167 208 240 272 272 272 170 394 18 371 7 47 39 371
371 7 5 5 371 18 295 160 161 162 208 164 249 250 298 18 371 7 5 5 371
371 7 5 5 371 18 18 192 193 278 13 280 391 198 18 18 371 7 5 5 371
371 7 15 7 371 18 18 224 225 226 13 105 229 230 18 18 371 7 15 7 371
371 7 47 39 178 408 435 178 257 258 13 260 261 178 408 435 178 7 47 39 371
371 7 5 5 114 528 529 371 417 207 13 206 421 371 528 529 114 7 5 5 371
371 7 5 5 144 6 6 178 408 178 13 178 408 178 8 6 144 271 5 5 371
371 7 5 5 5 5 5 114 528 114 13 114 528 114 7 5 5 5 5 5 371
178 344 178 7 5 15 7 144 6 144 6 144 6 144 271 15 7 5 178 344 178
114 393 371 7 5 47 39 5 5 5 5 5 5 5 5 47 39 5 371 392 115
114 425 371 7 5 5 5 5 15 7 5 5 15 7 5 5 5 5 371 424 115
359 425 371 7 5 5 5 5 47 39 5 5 47 39 5 5 5 5 371 424 360
295 425 178 344 500 500 500 433 7 5 5 5 5 432 500 500 500 500 178 424 298
18 263 114 391 193 193 193 178 344 500 500 500 500 178 391 193 193 193 114 394 18
18 295 114 521 522 523 520 114 391 193 193 193 193 114 521 522 523 520 114 298 18
