73007475
26 32
422 429 888 917 853 165 198 199 193 71 207 203 306 199 274 199 198 297 133 102 6 6 80 98 67 407 415 414 502 70 71 70
422 919 798 853 388 65 230 176 166 167 144 241 208 401 433 433 433 237 70 82 6 6 6 71 99 375 414 543 67 102 114 6
616 919 854 208 390 144 145 176 206 198 177 265 206 144 401 177 231 100 102 6 103 102 6 103 266 535 382 415 476 70 80 102
513 492 947 821 67 230 177 401 401 179 132 144 401 401 176 100 133 208 275 47 268 203 70 71 471 382 415 411 97 6 103 795
559 545 429 947 821 116 21 20 21 20 20 21 118 338 401 145 199 206 144 145 401 241 102 103 439 415 414 476 102 103 591 545
655 616 492 919 854 52 156 125 124 125 125 124 52 370 433 433 433 433 433 177 433 265 206 99 66 443 502 14 134 135 559 491
616 492 429 917 853 53 246 278 279 278 279 278 86 21 28 401 401 29 83 824 230 433 433 199 268 203 70 6 6 167 131 559
747 888 917 853 67 52 248 244 244 245 244 245 53 156 60 219 252 61 53 854 198 401 401 401 401 237 113 114 167 796 796 795
116 21 20 20 21 25 21 21 23 755 22 20 149 254 92 283 284 93 85 854 230 433 433 433 231 112 642 641 774 580 580 545
52 223 191 127 127 191 191 596 156 277 156 125 189 350 180 180 180 180 148 21 28 433 401 29 24 117 824 80 834 463 555 616
52 212 33 212 181 33 212 628 218 180 314 282 282 249 252 180 180 253 188 596 27 219 252 61 156 52 988 801 858 495 587 545
52 213 181 33 33 212 180 758 180 180 180 180 180 283 284 180 180 283 252 596 91 283 284 93 253 52 956 833 926 495 417 618
148 21 21 21 21 150 180 790 255 180 180 180 180 180 180 180 180 180 250 596 213 180 180 180 250 53 854 865 257 559 424 586
186 123 123 123 123 52 567 692 318 180 251 281 252 180 180 180 180 180 250 628 254 180 180 180 250 52 988 999 796 591 424 553
348 347 67 102 103 52 220 282 284 180 283 313 313 282 282 282 282 282 284 628 318 180 180 180 250 53 894 774 580 419 618 615
414 412 476 226 70 52 318 180 180 180 659 531 563 562 563 564 563 564 597 630 318 180 180 180 250 53 956 559 525 549 545 583
116 21 21 21 21 149 286 180 314 315 596 246 33 278 279 33 278 33 246 595 319 252 180 251 317 52 854 711 559 715 715 545
52 223 127 127 127 222 726 755 563 564 563 564 563 564 724 280 244 278 244 628 319 284 180 283 284 148 20 117 824 685 591 426
52 212 55 2 55 212 181 180 181 55 212 55 212 181 596 248 33 248 244 661 598 599 755 563 564 126 127 30 854 99 495 426
53 568 56 34 57 633 572 572 572 88 633 88 634 180 596 248 278 244 244 278 628 254 180 251 252 181 181 62 853 131 559 558
85 568 605 538 606 572 572 571 538 538 538 538 574 180 691 563 562 564 755 563 692 287 180 283 284 180 251 94 71 70 71 100
53 152 696 604 604 55 55 699 538 55 600 55 666 180 181 181 181 181 181 181 181 180 180 180 180 180 283 284 38 114 103 795
85 119 697 604 604 89 89 697 604 89 697 89 698 180 116 21 21 20 21 21 150 180 180 251 281 252 180 31 103 66 493 513
85 213 180 180 180 180 180 180 180 180 180 180 180 180 53 154 122 122 123 122 148 150 180 283 313 284 180 85 824 67 66 559
148 20 21 21 20 20 20 21 21 21 20 21 20 21 149 854 66 102 38 6 186 148 21 21 20 21 20 149 854 99 131 591
186 122 123 122 122 123 123 122 123 122 122 123 122 123 187 853 67 225 102 38 103 186 122 123 122 122 122 187 854 131 493 715
