5b005c5d
21 19
981 950 950 950 981 950 1014 251 283 284 285 286 254 950 950 1014 950 950 1014
1013 950 950 950 950 1014 282 283 316 358 358 318 286 287 950 1014 949 949 949
981 1013 949 950 1014 1013 314 570 317 317 317 317 318 319 1014 982 949 949 949
949 1014 981 950 950 218 639 602 317 317 317 317 446 312 219 1013 949 949 949
949 982 950 950 950 222 474 508 542 506 507 542 506 475 223 982 949 949 949
949 982 1013 950 950 191 476 540 571 538 539 571 541 477 190 949 949 949 949
949 949 981 982 950 191 281 509 574 317 317 573 478 312 190 949 949 949 949
949 949 949 981 982 218 313 510 349 349 355 414 349 280 219 1013 949 949 949
949 949 949 949 1014 218 281 543 317 317 387 413 317 312 219 949 949 949 949
949 949 949 949 1013 1014 281 543 388 349 317 349 349 280 949 949 949 949 949
949 949 949 949 949 949 313 543 360 360 360 360 605 280 981 982 949 949 949
949 949 949 949 949 949 313 543 382 352 355 415 349 280 950 983 949 949 949
949 949 949 949 981 1014 281 360 412 384 387 413 386 280 950 982 949 949 949
949 949 949 949 950 1013 246 360 360 412 358 360 360 247 950 949 949 949 949
949 949 949 949 950 982 278 308 309 342 343 340 341 279 950 1014 949 949 949
949 949 949 949 981 949 218 372 373 374 375 376 377 219 1014 981 949 949 949
949 949 949 949 950 982 222 404 405 406 407 408 409 223 981 950 949 949 949
949 949 949 951 950 982 191 186 437 438 439 440 187 190 1013 950 949 949 949
949 949 949 949 1014 949 191 220 189 220 221 188 221 190 949 1014 949 949 949
949 949 949 949 949 949 218 220 949 949 949 949 221 219 981 982 949 949 949
949 949 949 949 949 949 218 949 949 949 1013 949 949 219 951 949 949 949 949
