014c4d4e
25 46
6 45 782 14 720 816 817 14 782 720 27 87 212 244 245 212 212 276 213 213 213 213 213 213 213 213 213 213 213 213 213 213 213 213 277 244 244 213 213 213 277 212 212 212 84 85
6 71 70 6 71 848 849 113 71 44 71 130 23 88 213 213 213 245 276 213 213 213 213 213 213 213 213 213 213 213 277 84 85 86 276 213 213 213 213 277 22 21 87 26 130 163
6 6 103 102 114 82 82 6 81 70 6 82 71 130 21 276 213 213 213 213 213 213 213 213 213 213 213 213 213 277 20 130 130 163 27 20 23 276 277 20 130 163 130 14 996 130
38 105 720 164 44 6 6 103 102 38 103 102 114 45 915 916 917 916 917 916 917 916 917 916 917 916 917 916 916 917 918 720 164 162 163 130 163 21 24 130 162 720 70 103 816 817
102 137 163 782 206 47 807 808 809 46 505 145 199 198 947 820 821 820 821 820 820 821 821 820 821 820 821 820 820 821 950 199 162 163 164 5 163 198 506 507 473 209 102 836 848 849
720 142 79 71 502 199 839 840 841 507 437 433 177 401 979 852 853 852 853 852 852 853 853 852 853 852 853 852 852 853 982 401 508 164 165 198 145 401 442 443 433 901 209 102 82 71
70 6 6 103 507 176 871 872 873 144 805 176 782 230 979 884 885 884 885 884 884 885 885 884 885 884 885 884 884 885 982 433 436 506 507 401 401 433 805 401 307 301 164 132 102 111
114 6 103 505 437 177 199 144 273 401 177 307 164 720 1011 948 949 948 948 949 948 949 948 949 948 948 949 948 948 949 1014 401 401 436 437 433 433 401 199 144 508 782 778 779 780 760
561 102 45 230 231 274 435 231 230 231 130 55 56 130 53 980 981 980 981 980 980 980 981 980 981 980 981 980 980 980 58 230 231 306 231 502 177 433 231 270 176 672 810 811 812 790
465 742 742 720 164 144 231 116 53 54 57 245 124 55 244 213 213 213 213 213 213 213 213 213 213 213 213 213 213 277 245 54 130 70 82 71 641 238 198 231 238 642 842 843 844 790
553 579 425 561 198 231 55 244 245 244 213 213 245 244 213 213 213 213 213 213 213 213 213 213 213 213 213 245 212 244 245 245 58 102 6 38 71 643 230 199 640 720 791 724 726 790
617 583 616 465 366 367 21 276 213 213 213 213 213 213 213 213 213 213 213 213 213 213 213 213 213 213 213 213 213 213 213 213 245 56 102 114 143 677 274 231 70 71 100 230 724 790
513 551 545 592 366 367 55 244 213 213 213 213 277 244 213 213 213 213 213 213 213 213 213 213 213 213 213 213 213 213 213 213 213 245 54 163 168 71 230 275 172 102 71 198 724 792
559 516 522 593 144 209 23 87 213 277 245 212 244 213 213 213 245 212 276 213 213 213 213 277 212 244 213 213 213 213 213 213 213 213 245 58 119 168 80 230 209 70 143 230 176 165
71 559 589 198 231 99 100 130 21 212 213 213 213 213 213 213 213 213 277 87 276 277 245 212 213 213 213 213 213 213 213 213 213 213 213 245 124 44 6 45 165 102 103 164 144 199
6 71 14 270 209 676 467 130 165 23 276 213 213 213 213 213 213 277 20 130 27 276 213 213 213 213 277 276 213 213 213 213 277 212 276 87 26 130 46 720 165 131 198 145 724 792
6 6 103 144 199 198 506 507 199 915 916 917 916 917 916 917 916 917 918 206 3 125 276 213 213 245 244 212 276 213 84 86 22 21 26 130 165 807 808 809 132 165 230 724 176 782
6 143 198 433 401 433 436 437 434 947 820 821 852 853 820 821 820 821 950 176 130 21 212 213 213 213 213 213 277 22 130 163 130 165 130 782 165 839 840 841 164 131 164 144 724 199
111 80 144 401 433 402 177 231 230 979 852 853 884 885 852 853 852 853 982 401 199 915 916 917 916 917 916 916 917 918 130 165 165 130 720 165 130 871 872 873 782 164 131 230 401 231
199 274 231 230 401 176 720 782 165 1011 948 949 948 949 948 949 948 949 1014 177 434 947 820 821 852 853 820 821 820 950 199 507 199 198 199 466 507 145 401 199 165 804 164 198 297 70
230 401 199 720 230 231 130 165 130 55 980 981 980 981 980 980 980 981 56 208 433 979 852 853 884 885 852 853 852 982 401 401 177 307 294 473 433 433 433 401 145 199 198 177 237 113
198 433 307 70 71 165 130 119 57 244 213 213 213 213 213 213 213 277 20 3 238 1011 948 948 949 948 948 949 949 1014 177 403 199 782 165 300 301 230 231 230 401 177 231 783 70 103
433 231 783 113 103 119 55 244 213 213 213 213 213 213 213 213 277 212 56 162 100 55 980 981 980 981 980 980 981 56 130 230 177 209 720 70 82 71 676 130 238 720 14 815 102 71
230 199 815 46 55 212 244 213 277 212 212 244 213 213 213 213 245 245 22 130 57 244 213 277 212 244 213 213 213 213 54 116 118 130 163 102 38 103 642 70 71 70 38 82 82 38
100 230 199 100 23 212 276 277 212 244 213 213 213 277 212 276 213 245 52 55 244 213 277 244 213 277 212 212 276 213 213 245 212 52 117 118 142 71 672 102 38 38 103 102 38 103
