1800571a
25 29
66 484 430 426 426 426 426 426 426 426 426 426 426 426 426 426 426 426 426 426 426 426 426 484 323 2 162 761 724
66 554 896 897 897 897 897 897 897 897 897 897 897 897 897 897 897 897 897 897 897 897 897 810 354 2 162 729 724
70 554 723 722 722 722 722 722 722 722 722 722 722 722 722 722 722 722 722 722 722 722 722 423 387 34 761 724 724
142 586 720 721 721 721 721 721 721 721 721 721 721 721 721 721 721 721 721 721 721 721 721 519 519 759 724 724 724
484 430 484 720 484 430 484 720 721 721 520 426 426 426 426 426 426 426 426 426 426 426 521 519 519 758 724 724 794
491 896 810 720 810 896 491 720 721 520 553 723 722 419 722 722 722 722 722 722 722 722 552 521 430 426 426 523 37
491 723 547 755 547 827 491 720 721 491 723 721 721 721 520 918 426 918 521 720 721 721 722 491 896 897 897 555 2
491 720 721 721 721 721 491 720 721 583 720 721 583 430 583 950 951 950 583 430 583 720 721 583 723 722 722 587 2
491 720 721 721 419 721 491 720 721 615 452 453 615 985 615 982 983 982 615 985 615 452 453 615 720 520 426 426 521
525 462 426 426 426 460 493 720 721 775 452 453 775 963 775 1014 1015 1014 775 963 775 452 453 775 720 491 723 722 491
491 896 897 897 897 897 491 720 721 547 827 722 547 596 865 656 624 657 865 628 547 827 722 547 755 491 720 1 491
491 723 1 723 1 723 491 720 721 721 484 430 484 688 690 688 627 689 691 689 484 430 484 720 721 491 720 722 491
491 720 722 1 723 721 491 720 721 721 810 896 810 484 688 627 627 627 689 484 810 896 810 720 721 491 720 1 491
491 720 721 722 721 721 491 720 721 721 547 827 547 810 720 596 625 628 721 810 855 827 547 755 721 491 720 722 491
484 430 484 720 484 430 484 720 721 721 721 721 721 547 484 688 627 689 484 855 721 721 721 721 721 491 720 1 491
810 896 810 720 810 896 810 720 721 721 719 720 719 720 810 452 454 453 810 720 719 720 719 720 721 491 720 722 491
547 827 547 721 547 827 547 755 721 721 751 721 751 721 547 827 722 722 547 755 751 721 751 721 721 491 720 721 491
721 721 721 721 721 721 721 721 721 721 721 721 721 721 721 721 721 721 721 721 721 721 721 721 721 491 720 721 491
484 430 484 484 433 461 426 484 720 721 484 433 461 426 484 484 430 484 720 721 719 720 719 720 721 484 720 721 484
742 614 742 742 322 484 985 810 720 721 810 985 484 322 742 742 614 491 720 721 751 721 751 721 721 810 452 453 810
615 896 615 615 354 810 723 547 755 721 547 827 810 354 615 615 896 491 720 721 721 721 721 721 721 547 827 722 547
775 963 775 775 386 421 721 721 721 721 721 721 423 387 775 775 963 484 430 521 720 721 721 721 721 721 721 721 721
710 107 710 384 422 422 721 721 721 721 721 721 519 519 385 710 107 742 614 491 720 721 721 721 721 721 721 721 721
761 665 665 724 422 484 430 426 426 426 426 426 484 519 724 762 162 615 896 484 430 484 484 430 484 484 430 484 484
724 724 724 724 484 742 614 609 609 609 609 609 742 484 724 724 762 775 963 742 614 742 742 614 742 742 614 742 742
