1800191a
19 22
822 821 821 821 821 821 821 822 821 821 821 822 484 430 426 426 426 426 460 521 184 244
821 821 821 822 821 822 821 821 821 822 821 821 742 867 866 866 866 866 866 458 184 276
821 821 484 820 821 821 484 432 820 821 821 821 423 824 825 824 824 825 825 458 184 276
821 822 742 486 454 453 742 458 820 821 821 821 519 821 821 821 821 821 821 458 184 244
822 821 423 181 181 181 537 458 820 456 424 425 424 425 424 424 425 457 820 458 184 276
821 822 519 213 213 213 277 458 820 520 747 747 747 747 747 747 747 521 820 458 184 244
822 822 484 460 460 460 460 493 820 458 867 912 912 913 911 911 867 458 820 525 426 426
821 822 458 823 825 825 825 458 820 458 819 944 944 624 946 946 819 458 820 458 823 719
821 821 458 820 1 1 820 458 820 458 880 688 688 627 689 689 849 458 820 458 820 815
821 821 458 820 825 825 821 458 820 458 880 849 688 627 689 849 849 458 820 458 820 821
821 822 552 427 820 428 460 493 820 552 426 427 850 849 849 428 426 484 820 458 820 821
822 821 866 866 451 866 866 458 820 866 866 866 452 454 453 866 866 679 820 458 820 821
821 822 825 825 825 825 825 458 820 960 961 961 452 454 453 960 960 387 820 490 820 520
822 822 821 821 821 821 821 458 820 825 825 824 824 825 825 825 825 519 821 866 451 458
821 821 719 820 484 820 821 458 820 822 821 821 821 821 821 821 822 519 821 825 825 458
821 822 815 822 742 452 453 552 484 820 821 484 432 820 821 821 821 519 821 821 821 458
822 821 821 821 423 151 181 866 742 486 453 742 458 820 520 426 426 426 460 461 462 553
821 822 719 820 519 184 213 182 537 181 181 537 458 820 458 867 866 866 866 484 867 866
822 822 815 821 484 184 276 213 277 213 213 277 458 419 458 823 825 825 825 742 823 825
