1800191a
24 24
213 213 213 277 458 820 520 747 747 747 747 747 747 747 521 820 458 184 244 213 213 213 245 276
460 460 460 460 493 820 458 867 912 912 913 911 911 867 458 820 525 426 426 426 426 426 521 183
823 825 825 825 458 820 458 819 944 944 624 946 946 819 458 820 458 823 719 823 719 823 458 183
820 33 33 820 458 820 458 880 688 688 627 689 689 849 458 820 458 820 815 858 815 858 458 183
820 825 825 821 458 820 458 880 849 688 627 689 849 849 458 820 458 820 821 33 820 821 458 183
427 448 428 460 493 820 552 426 427 850 849 849 428 426 484 820 458 820 821 825 821 821 458 183
866 451 866 866 458 820 866 866 866 452 454 453 866 866 679 820 458 820 821 821 821 821 458 183
825 825 825 825 458 820 960 961 961 452 454 453 960 960 387 820 490 820 520 462 416 492 493 183
821 821 821 821 496 820 825 825 824 824 825 825 825 825 519 821 866 451 458 867 451 866 458 183
821 484 820 821 458 820 822 821 821 821 821 821 821 822 519 821 825 825 458 823 825 825 458 183
822 742 452 453 552 484 820 821 484 432 820 821 821 821 519 821 821 821 458 820 719 820 458 183
821 423 151 181 866 742 486 453 742 458 820 520 426 426 426 460 461 462 553 820 815 858 458 183
821 519 184 213 182 537 181 181 537 458 820 458 867 866 866 866 484 867 866 820 821 821 458 183
821 484 184 276 213 277 213 213 277 458 419 458 823 825 825 825 742 823 825 821 821 821 458 183
822 552 426 426 426 426 426 426 426 426 460 493 820 821 719 820 515 858 822 821 719 820 458 183
821 866 866 866 866 866 866 866 866 866 866 458 820 821 815 858 821 822 821 822 815 858 458 183
821 825 825 824 825 825 825 824 825 825 825 458 820 821 821 821 484 820 821 821 821 821 458 183
426 426 426 426 426 426 521 821 821 719 820 525 427 427 820 460 461 462 583 820 821 583 465 183
866 866 866 866 866 866 458 820 821 815 858 458 867 866 820 866 458 867 615 820 821 615 867 183
960 961 960 961 960 961 484 433 426 484 820 484 823 825 821 825 458 963 647 452 453 647 963 215
824 825 825 825 824 825 679 867 866 742 820 742 820 821 719 820 458 214 185 876 842 186 181 213
821 821 822 821 821 822 386 824 825 515 858 515 858 821 815 858 458 183 217 877 841 218 213 245
821 821 821 821 822 821 422 821 821 821 821 821 821 821 821 821 458 183 217 876 842 218 213 277
821 821 821 821 822 821 484 433 426 427 426 427 426 460 427 426 553 184 249 877 841 250 276 277
