1800571a
10 15
960 961 715 426 426 426 883 766 883 426 426 426 715 962 961
960 961 768 617 618 719 797 798 799 719 617 618 768 962 961
33 723 800 681 682 715 829 830 831 715 681 682 800 723 33
722 721 548 827 722 768 654 627 689 768 723 722 548 755 722
424 457 452 454 453 800 452 454 453 800 452 454 453 456 425
484 495 723 722 722 547 288 289 290 547 827 722 722 520 484
742 484 495 720 721 721 721 721 721 721 721 721 520 484 742
615 742 484 430 426 521 720 721 721 520 426 426 484 742 615
775 615 742 614 609 459 452 454 453 459 614 609 742 615 775
426 426 426 426 426 484 452 454 453 484 430 426 426 426 426
