1800481a
13 15
525 462 426 484 720 615 802 803 804 615 720 484 430 460 493
459 953 954 615 451 775 834 964 836 775 451 615 953 954 459
459 985 986 775 784 548 590 625 628 548 818 775 985 986 459
459 787 786 548 754 785 596 625 628 785 785 548 818 786 459
459 784 785 785 785 785 596 625 628 785 785 785 785 785 459
484 433 426 426 484 784 688 627 689 785 484 433 426 426 484
742 614 640 641 459 784 785 785 785 785 459 614 640 641 742
426 426 426 426 484 430 484 784 785 484 430 484 672 673 615
608 609 608 609 810 867 832 452 453 832 867 459 646 740 775
897 898 897 898 352 818 548 818 786 548 818 484 430 426 484
824 825 824 825 422 785 785 785 785 785 785 810 867 866 459
821 822 821 822 422 785 785 785 785 785 785 837 818 786 459
426 426 426 426 484 433 426 426 484 784 785 785 785 785 459
