a500abac
32 32
133 601 355 387 930 355 772 772 772 966 772 772 67 727 905 906 907 908 909 728 67 772 772 966 355 67 772 836 772 772 931 387
631 598 866 896 961 387 772 772 900 966 772 772 99 727 937 938 939 940 941 728 99 772 772 966 355 67 67 70 71 67 899 387
601 355 898 928 802 821 142 82 6 966 70 82 71 727 969 970 971 972 973 760 70 82 82 966 355 67 70 103 102 71 931 387
600 820 930 819 70 82 103 102 6 998 936 102 103 756 758 758 758 758 758 757 102 6 934 967 821 99 868 772 70 772 899 387
600 133 898 772 102 772 772 772 102 79 903 70 175 67 759 691 723 723 791 67 174 6 903 821 98 98 772 772 102 772 931 387
601 100 930 772 355 772 868 772 70 6 82 6 71 99 759 723 691 691 791 99 70 6 103 112 71 995 769 771 981 770 963 387
664 852 898 355 355 355 355 981 102 6 966 102 6 71 756 790 790 790 757 70 6 103 966 851 102 931 801 835 387 834 835 821
600 355 962 771 355 770 769 994 981 142 998 999 936 102 71 67 99 67 70 103 934 935 1000 821 70 931 387 355 830 100 163 99
600 387 834 835 821 834 800 898 355 142 79 71 998 1003 142 1001 1002 1003 142 1001 1000 821 67 70 103 899 355 355 100 15 14 100
600 957 822 819 98 852 355 930 387 142 6 167 132 70 103 772 772 772 102 79 80 718 67 47 67 931 387 821 164 102 6 71
599 630 132 133 852 355 355 930 387 142 868 772 132 102 71 772 772 868 70 103 119 55 58 780 99 931 387 355 355 70 38 6
780 599 630 164 924 866 896 961 387 142 71 772 772 772 113 772 772 772 102 71 27 212 212 56 718 960 867 387 355 102 6 38
355 780 600 133 924 898 928 802 821 142 6 82 71 72 6 868 772 772 70 103 55 212 212 22 70 834 899 355 355 70 38 103
387 718 600 851 820 930 819 70 82 6 6 6 6 6 6 82 71 70 6 71 25 87 26 70 6 71 931 387 355 102 6 71
355 355 664 923 133 962 994 102 114 114 6 114 103 102 114 114 6 114 103 102 45 99 70 6 6 6 931 355 355 174 38 103
355 821 600 821 100 834 962 769 994 981 110 995 769 770 833 981 110 833 769 769 994 981 168 995 769 769 963 387 819 112 6 71
881 100 2 133 100 133 834 800 898 387 889 931 801 800 865 387 889 865 800 800 930 387 889 931 801 800 835 821 165 136 38 103
100 852 600 718 851 133 133 852 962 769 769 963 387 819 827 830 133 827 827 827 962 769 769 963 387 819 827 131 70 169 102 71
852 355 664 780 355 981 132 822 834 800 800 835 821 164 74 134 71 70 77 164 834 800 800 835 821 140 15 75 102 109 132 102
822 387 600 355 387 826 133 852 355 355 819 957 140 75 112 38 6 6 80 100 133 133 133 133 132 102 6 137 99 163 631 538
164 957 599 630 891 957 100 822 821 957 132 76 6 73 72 6 38 6 71 70 71 99 66 67 164 70 38 103 132 631 598 718
71 130 780 599 597 672 741 100 140 140 141 132 102 6 6 38 6 38 103 102 6 82 71 70 82 6 6 77 164 600 780 132
6 71 164 718 600 100 640 76 103 172 166 135 72 38 38 38 167 173 165 140 113 6 38 6 38 38 6 80 100 600 99 133
38 103 100 164 600 718 674 14 740 741 467 142 38 103 102 114 135 75 76 6 6 38 6 38 105 166 38 109 780 600 100 165
113 71 75 100 599 630 596 34 630 165 674 142 169 780 100 76 6 73 70 103 102 114 103 102 109 99 46 631 538 598 132 133
105 47 107 100 132 628 629 14 599 570 597 142 109 707 718 165 102 6 169 96 740 673 674 718 631 538 34 598 676 718 164 100
109 165 76 82 71 100 70 103 165 780 628 34 571 630 672 741 76 6 175 67 100 133 780 631 598 780 14 133 133 132 100 130
164 133 112 38 6 82 6 71 165 100 70 38 71 599 630 780 106 47 107 66 718 631 570 598 718 70 103 133 133 164 640 100
100 140 75 102 38 6 38 6 71 133 102 38 103 718 600 596 539 34 539 539 539 598 100 100 164 113 71 70 82 71 676 780
164 102 137 70 6 38 6 38 103 165 100 102 71 164 636 598 780 132 74 100 100 70 71 70 82 38 38 6 38 81 498 674
100 70 38 6 38 114 38 6 82 75 74 134 103 70 2 135 67 74 134 71 70 6 6 38 38 6 6 38 6 6 71 100
70 38 6 38 103 99 166 38 6 73 136 38 82 167 600 38 135 134 6 38 38 6 38 6 6 38 38 6 38 38 6 71
