79007a7b
31 29
323 180 245 247 256 256 256 149 149 149 5 262 149 5 5 5 262 149 5 262 149 149 256 256 256 180 181 246 323
323 134 418 33 256 256 256 19 20 21 38 5 180 38 2 39 180 5 39 16 17 18 256 256 256 449 418 33 323
323 416 417 418 149 149 149 51 52 53 70 38 180 70 34 70 180 39 70 48 49 50 149 149 149 416 417 418 323
5 416 417 5 83 84 323 449 418 418 418 70 449 26 27 28 418 70 449 418 418 418 323 81 82 5 416 417 5
38 416 417 38 115 116 323 134 417 12 416 418 193 58 59 60 194 418 417 12 416 134 323 113 114 38 416 417 38
70 167 168 70 512 643 323 416 417 44 417 417 225 90 59 92 226 417 417 44 417 417 323 512 641 70 167 168 70
641 642 643 642 513 515 5 262 149 149 150 150 353 122 123 124 352 150 150 150 149 149 5 544 548 642 643 641 642
546 516 515 515 516 547 38 180 247 246 81 82 5 13 14 15 5 83 84 180 247 181 39 576 516 547 515 546 516
547 547 547 308 608 515 70 180 247 246 113 114 38 45 46 47 39 115 116 180 247 181 70 609 547 308 608 547 547
548 515 546 244 576 677 641 642 641 642 641 641 70 167 169 168 70 512 642 642 641 641 642 547 515 244 576 548 515
547 516 515 276 608 515 547 547 677 548 547 515 640 640 641 642 643 515 547 548 515 677 547 516 516 276 608 547 516
169 169 168 308 308 5 577 546 515 5 240 241 242 243 240 241 242 243 384 5 577 546 515 5 308 308 167 169 169
169 169 168 144 147 244 13 14 15 244 144 145 146 145 146 145 146 145 147 244 13 14 15 244 144 147 167 169 169
484 484 481 176 179 244 45 46 47 244 176 177 178 177 178 177 178 177 179 244 45 46 47 244 176 179 483 484 484
482 482 481 208 211 276 512 643 642 276 208 209 210 209 210 209 210 209 211 276 512 643 643 276 208 211 480 482 482
482 482 481 484 485 5 577 548 677 5 483 484 485 485 484 485 485 484 484 5 608 547 547 5 483 485 481 482 482
240 241 240 241 240 5 609 546 515 5 240 241 242 243 240 241 242 243 384 5 576 548 515 5 240 241 240 241 240
246 181 246 181 181 38 608 547 516 39 323 246 246 246 246 246 246 246 323 38 609 547 516 39 180 247 246 181 181
246 181 246 181 181 70 577 515 515 70 323 134 418 33 33 33 449 134 323 70 608 515 515 70 180 247 246 181 181
642 641 643 641 643 643 513 677 515 641 323 416 417 418 418 418 417 417 323 512 513 677 515 643 642 641 641 642 641
547 547 515 515 546 548 546 548 515 515 384 292 5 13 14 15 5 292 385 608 677 677 548 546 515 546 548 547 547
256 256 256 149 149 149 5 576 548 548 247 246 38 45 46 47 38 180 247 576 546 548 5 262 149 149 256 256 256
256 256 256 16 17 18 38 609 546 546 247 246 70 167 169 168 70 180 247 608 515 677 39 19 20 21 256 256 256
256 256 256 48 49 50 70 576 546 548 642 641 641 642 642 642 641 642 641 514 548 548 70 51 52 53 256 256 256
149 149 149 512 642 642 641 513 514 677 677 514 515 546 515 546 515 514 515 514 514 515 642 642 642 641 149 149 149
5 384 241 244 608 548 515 548 244 241 240 241 242 243 240 241 242 243 384 241 244 608 515 548 548 244 241 384 5
244 144 147 6 576 515 677 546 6 144 145 146 145 145 145 145 145 145 146 147 6 576 515 677 548 6 144 147 244
244 176 179 38 577 546 515 515 39 176 177 178 177 177 177 177 177 177 178 179 38 609 677 546 515 39 176 179 244
6 208 211 72 167 169 169 168 72 208 209 210 209 209 209 209 209 209 210 211 72 167 169 169 168 72 208 211 6
39 483 484 70 199 169 169 168 70 483 484 484 485 485 484 484 485 484 484 484 70 199 169 169 168 70 483 484 39
72 482 482 484 484 484 484 484 485 482 482 482 482 482 482 482 482 482 482 482 484 484 484 484 484 485 482 482 72
