79007a7b
10 15
308 16 17 18 736 352 6 79 6 355 740 19 20 21 308
276 48 49 50 736 323 38 111 38 291 740 51 52 53 276
308 672 33 672 736 323 70 240 70 323 740 672 33 672 308
276 673 640 515 800 6 107 640 106 6 804 673 640 515 276
308 167 169 168 384 38 673 515 515 38 385 167 169 168 308
276 449 12 418 247 70 167 169 168 70 247 449 12 418 276
308 416 44 417 418 418 133 162 165 418 418 417 44 417 308
6 262 258 258 6 416 133 162 165 417 6 262 258 258 6
38 80 81 82 38 416 133 162 165 417 38 83 84 85 38
70 112 113 114 70 416 133 162 165 417 70 115 116 117 70
