01020304
21 15
38 81 102 103 685 684 559 715 715 587 588 512 428 582 522
166 103 720 67 131 67 67 67 684 559 525 587 512 615 616
45 782 70 77 851 852 853 67 162 720 559 524 587 514 578
14 132 168 109 883 884 885 99 741 673 65 559 525 587 588
6 71 72 71 915 916 917 14 132 782 685 684 559 715 524
38 6 6 81 70 82 82 6 82 77 783 66 65 684 495
102 103 102 114 103 102 38 6 105 66 14 99 66 66 495
57 54 67 807 808 809 168 38 109 162 102 79 71 685 495
213 22 99 839 840 841 108 103 675 782 720 113 103 720 559
26 782 131 871 872 873 67 771 499 66 70 103 784 785 65
785 672 773 67 230 390 99 67 720 70 6 82 71 720 164
56 720 170 99 55 56 55 52 131 102 103 168 6 82 71
245 52 118 55 244 245 244 124 132 70 71 106 104 6 169
213 213 245 244 213 277 276 22 76 6 114 82 82 105 107
277 22 27 84 85 86 26 132 67 102 109 102 111 109 131
26 70 71 76 82 82 109 260 390 133 720 67 804 67 67
98 142 103 772 102 103 208 333 782 804 131 208 231 99 816
82 103 99 198 506 99 704 366 367 366 367 807 808 809 848
103 260 337 177 436 473 199 368 273 176 99 839 840 841 67
332 333 677 783 230 176 230 231 296 805 199 871 872 873 99
782 366 720 815 198 177 199 67 364 365 230 273 231 67 131
