0102a004
21 32
198 401 231 70 81 559 513 429 646 582 587 545 582 580 545 494 590 624 684 685 136 6 103 132 165 66 782 102 6 903 904 905
230 176 44 38 38 932 495 580 579 617 583 424 592 559 589 684 720 816 817 70 111 47 100 742 720 165 132 130 102 935 936 937
208 401 199 47 102 47 559 715 587 545 494 590 685 782 880 882 932 848 46 742 742 742 591 459 529 742 742 130 132 967 968 969
71 230 401 145 199 100 684 685 559 589 684 685 720 880 913 914 720 932 591 545 581 580 417 618 551 545 429 719 165 204 435 209
103 198 401 401 401 199 206 100 782 100 816 881 880 946 945 946 783 14 495 424 560 559 549 545 582 424 592 684 685 198 231 676
71 502 401 401 401 401 177 199 130 720 848 913 946 720 165 782 815 113 559 589 624 3 559 746 494 590 782 163 132 366 367 720
6 80 472 401 401 231 130 238 15 100 130 815 782 742 742 742 932 102 6 82 79 782 782 711 568 100 130 206 198 176 165 644
81 198 473 401 401 508 112 82 6 71 782 165 591 580 512 429 529 742 47 111 6 6 79 71 564 165 165 230 435 401 273 508
103 144 177 401 401 436 506 102 114 103 742 591 491 583 587 512 553 513 718 165 102 114 6 103 599 570 630 198 401 177 403 436
507 176 130 230 401 177 434 205 684 591 424 583 587 579 417 646 615 587 544 561 742 742 47 165 198 209 2 230 176 332 333 230
306 231 99 204 433 199 144 265 591 417 618 615 523 417 618 465 559 524 455 429 581 545 718 165 144 199 600 165 230 199 366 367
71 70 71 234 232 307 230 176 559 747 560 559 715 456 429 496 568 559 587 512 553 424 592 208 401 271 599 630 130 932 293 782
111 114 103 332 333 99 130 230 199 130 684 653 685 559 623 560 564 685 559 587 544 590 130 198 401 307 130 600 70 80 720 165
642 641 644 643 396 130 643 130 230 199 274 199 130 684 685 631 598 130 684 559 558 782 274 297 238 631 570 598 102 143 130 99
198 209 99 130 144 209 720 641 130 230 231 306 261 130 130 564 130 274 199 130 720 130 144 265 631 598 720 130 70 38 71 70
333 903 904 905 270 199 804 130 736 130 783 332 333 130 631 598 274 401 401 145 199 274 401 231 599 630 112 79 114 103 47 102
366 935 936 937 144 177 293 673 499 165 815 130 230 209 2 208 231 144 401 295 294 231 238 70 45 600 142 103 938 939 940 70
333 967 968 969 292 996 130 704 684 686 742 720 165 631 598 130 165 230 231 70 71 165 70 81 631 598 142 71 970 971 972 102
238 804 230 209 782 130 130 770 591 515 544 718 165 632 684 685 742 782 44 103 110 3 47 103 600 70 6 81 909 910 911 70
817 230 199 900 358 130 673 591 555 416 618 429 561 599 630 591 545 561 742 130 685 130 165 631 598 102 114 6 71 130 70 6
849 99 306 231 130 675 652 559 587 422 615 617 429 561 632 495 424 581 545 561 684 653 685 600 685 112 71 102 103 70 38 38
