b100b2b3
26 32
792 691 691 691 691 790 790 790 790 757 870 868 836 836 836 836 836 836 836 836 871 764 691 691 691 691 691 691 691 791 931 355
792 691 691 691 791 870 868 836 836 933 933 805 804 804 804 2 804 804 804 804 903 793 790 790 790 790 790 790 790 791 931 387
792 691 691 691 791 934 711 804 804 712 842 698 730 581 677 34 678 581 698 730 836 836 836 836 836 836 836 836 871 763 899 387
792 790 790 790 757 934 743 698 730 744 906 700 729 614 709 610 611 615 732 729 841 711 804 804 804 804 804 712 903 728 931 355
728 870 868 836 836 933 698 729 729 730 730 729 729 640 641 642 643 644 729 729 906 743 698 730 730 730 1 744 903 728 931 387
728 934 711 804 804 777 700 729 729 729 875 668 729 672 673 674 675 676 729 729 730 730 729 729 1 667 731 730 903 728 899 355
728 934 743 698 730 809 729 729 729 729 906 700 729 704 705 706 707 708 729 729 875 668 1 667 731 729 1 667 903 728 931 387
728 934 698 729 729 729 729 729 729 729 730 729 729 581 741 738 739 581 668 729 907 699 731 729 729 729 731 729 903 728 931 355
728 934 699 729 729 729 729 999 773 773 998 699 729 613 732 36 729 613 732 729 999 773 998 668 1 667 729 729 903 728 899 387
728 966 773 773 998 668 729 903 801 800 966 998 668 729 729 729 729 729 729 999 967 801 934 699 731 729 1 667 903 728 931 355
728 834 800 800 902 699 729 903 355 355 834 966 773 773 773 773 773 773 773 967 929 821 934 699 729 729 731 729 903 728 931 387
792 758 726 789 934 699 729 903 355 355 355 834 800 800 800 800 800 800 800 835 819 66 966 998 904 667 936 999 967 728 931 355
4 791 870 868 933 699 729 932 933 871 387 891 829 829 827 829 829 827 829 830 163 98 834 934 698 729 730 903 929 5 899 387
792 791 902 711 777 700 729 776 712 932 836 933 871 66 163 66 870 868 836 836 836 836 836 933 699 729 729 903 794 791 931 355
994 763 934 743 669 729 729 808 744 776 778 712 932 836 836 836 933 711 804 804 804 804 804 777 700 729 729 903 792 791 931 387
930 728 902 698 729 729 729 729 730 808 730 744 776 778 746 747 777 743 698 730 730 730 730 809 730 729 999 967 792 791 899 355
898 728 934 699 729 729 729 729 729 729 729 730 808 730 730 730 730 730 729 875 668 729 729 875 668 729 903 929 761 791 899 387
930 728 966 773 773 773 773 773 773 773 773 998 668 729 729 729 729 729 999 773 773 773 773 773 773 773 967 794 691 791 931 355
898 728 834 800 800 800 800 800 800 800 800 934 699 729 729 729 729 729 903 801 800 800 800 800 800 800 835 761 691 791 931 387
930 792 726 758 758 758 758 726 726 726 725 962 995 833 668 729 833 994 963 794 726 726 726 726 758 758 758 790 790 757 899 355
962 769 994 764 691 791 995 769 769 994 763 834 899 865 794 791 865 930 929 761 995 769 769 994 792 691 791 995 769 769 963 387
834 800 898 793 790 757 931 801 800 930 792 725 931 794 691 691 791 930 794 791 931 801 800 898 793 790 757 931 801 800 835 821
830 882 833 896 832 961 833 387 894 930 792 791 931 792 691 691 791 930 792 791 931 355 894 833 896 832 961 833 953 829 830 70
71 890 865 801 800 835 865 819 890 930 793 757 899 792 691 691 791 930 793 757 899 355 985 865 928 800 835 865 821 15 141 113
6 77 829 827 829 827 830 66 131 833 896 961 833 792 691 691 791 833 896 961 833 355 985 829 827 827 827 827 70 6 38 6
38 80 164 164 70 82 15 141 890 865 928 835 865 792 691 691 791 865 928 835 865 821 163 70 71 163 70 82 6 38 6 38
