2e003430
11 15
555 425 492 720 523 549 524 619 556 454 429 528 718 355 711
625 616 492 429 720 715 657 658 588 625 544 719 718 355 679
587 576 429 429 592 819 828 950 559 417 618 592 355 591 576
559 587 576 496 923 99 99 99 820 590 592 355 718 495 619
878 559 587 545 497 99 99 99 99 886 355 355 591 524 417
878 847 559 746 560 718 99 99 99 99 914 355 495 523 454
783 718 868 718 679 980 853 920 917 99 822 711 463 524 619
847 718 99 99 978 355 355 742 355 99 99 99 463 524 587
497 718 99 99 978 355 655 576 648 718 99 99 559 524 524
592 979 99 978 742 591 555 556 544 497 742 851 820 559 559
355 355 980 591 579 452 587 588 423 615 576 497 99 820 355
