2e003430
30 20
619 544 551 587 556 416 646 492 551 623 528 974 975 976 746 583 587 457 583 587
416 618 582 524 587 422 492 492 582 746 592 1006 1007 1008 527 553 524 587 544 683
422 492 615 555 555 616 429 429 615 594 745 718 755 718 563 492 583 524 456 429
454 615 555 556 556 576 492 551 524 626 593 788 691 789 595 492 553 524 417 615
587 451 587 556 556 556 544 582 524 475 476 743 755 591 456 460 496 559 589 559
524 485 555 556 556 556 422 429 583 524 508 427 971 609 523 544 560 947 948 495
525 524 587 588 588 625 616 492 429 720 715 746 971 525 523 616 593 836 980 495
524 555 416 583 657 587 576 429 429 592 819 198 271 559 524 577 497 755 591 523
555 588 422 465 355 559 587 576 496 923 99 270 231 822 559 658 545 971 524 417
625 610 454 496 355 819 559 587 545 497 99 396 99 980 742 979 718 822 559 424
619 556 556 617 529 889 774 559 746 560 198 231 980 591 576 497 979 980 355 558
583 625 556 617 528 851 918 718 711 356 301 978 355 495 619 576 497 742 742 355
429 583 625 576 528 774 742 851 99 99 978 742 591 524 417 584 576 429 429 497
577 553 587 625 578 576 429 497 979 980 591 579 452 555 521 614 556 617 429 429
587 512 720 587 588 588 689 592 355 591 524 619 482 588 422 551 587 576 429 429
559 587 577 720 562 658 747 355 355 495 524 625 556 610 616 429 583 587 576 429
711 559 587 532 576 648 718 822 711 559 524 587 625 556 576 460 429 583 619 689
99 718 495 587 625 544 497 851 99 820 559 524 587 625 556 617 429 553 587 423
99 718 559 524 587 455 465 742 851 99 820 559 657 658 588 426 429 592 559 491
99 99 820 559 525 587 532 512 497 851 99 99 820 679 431 746 592 355 493 524
99 99 99 820 559 658 587 556 576 497 851 99 99 99 820 355 355 743 591 555
99 99 99 99 99 820 559 587 625 544 719 744 745 851 99 852 591 513 583 587
99 99 99 99 718 99 820 559 417 618 592 355 355 355 742 591 524 555 576 720
718 852 742 851 99 99 99 820 590 592 355 355 743 591 521 583 524 587 625 512
497 591 577 497 742 742 742 743 742 742 355 591 524 555 422 460 720 524 587 556
580 524 555 578 544 582 532 616 585 513 561 559 555 556 616 461 553 523 524 587
523 524 587 625 454 551 587 577 582 524 580 612 625 556 512 460 585 524 523 555
524 523 555 620 556 576 583 587 512 583 524 587 588 556 556 544 582 524 619 416
524 555 556 556 556 556 578 514 450 579 524 523 555 556 556 422 429 583 587 423
524 587 556 620 588 611 556 556 708 554 620 554 556 620 588 423 460 461 720 616
