a500a6a7
29 29
853 70 103 600 47 104 71 102 103 102 6 38 71 70 6 6 103 600 130 132 854 559 746 592 885 70 71 946 355
821 46 631 598 780 136 81 67 14 130 102 114 103 102 6 81 130 2 70 71 946 945 718 957 70 6 6 71 820
71 70 2 71 70 114 114 82 103 631 538 597 139 130 102 103 631 598 102 38 71 70 71 70 38 103 102 103 854
6 103 600 102 103 854 853 46 631 598 780 628 538 539 538 539 605 130 130 46 102 38 38 38 38 71 852 721 810
81 718 600 130 857 894 945 718 599 630 70 71 70 82 71 130 599 570 571 570 630 172 173 102 38 143 774 513 618
102 71 599 570 630 596 570 571 699 598 102 114 6 6 81 130 131 132 131 14 599 570 630 70 38 103 886 559 545
99 113 82 71 599 629 130 14 599 570 630 130 102 6 103 206 807 808 809 102 71 14 600 102 103 67 854 655 616
71 46 102 103 100 14 70 6 71 14 599 571 630 46 204 271 839 840 841 70 6 81 599 630 98 978 774 616 429
103 14 807 808 809 102 103 102 103 102 82 71 599 630 236 176 871 872 873 102 114 6 71 600 67 946 591 545 429
82 103 839 840 841 202 269 198 275 206 102 103 130 600 260 231 130 395 206 198 205 113 103 600 98 978 559 746 592
103 100 871 872 873 236 402 177 402 307 208 199 260 2 293 14 332 333 230 307 235 102 71 599 630 946 945 946 355
130 206 130 395 99 198 231 132 331 99 99 292 293 600 70 6 71 366 367 70 71 70 6 77 600 67 718 132 946
208 177 145 401 145 177 199 807 808 809 130 99 631 605 102 114 81 292 261 102 114 103 172 107 600 131 132 99 132
70 71 230 177 176 206 238 839 840 841 130 631 598 599 570 630 46 332 333 132 807 808 809 132 599 630 132 780 99
102 6 82 71 292 177 199 871 872 873 780 600 70 82 71 600 99 99 366 367 839 840 841 100 99 600 978 387 858
858 113 114 6 71 208 176 260 390 130 631 598 102 114 103 599 630 780 292 199 871 872 873 989 132 600 820 923 132
780 46 131 113 103 718 292 293 631 538 598 718 861 689 862 99 599 630 98 230 199 395 854 355 851 599 630 924 851
597 631 539 34 539 538 602 538 598 70 71 857 774 513 497 926 853 599 570 630 230 231 924 894 821 780 600 946 355
628 598 99 102 71 100 600 14 70 38 81 132 924 495 545 593 821 718 989 599 630 852 923 718 131 131 600 978 355
131 14 131 70 81 70 2 38 38 38 38 71 822 559 589 945 99 857 355 387 600 948 355 851 132 631 598 946 355
82 114 82 114 38 103 600 102 103 102 114 81 100 924 821 780 130 99 822 355 636 630 822 821 131 599 630 978 355
103 14 46 131 46 130 599 571 570 571 630 46 857 894 926 853 854 853 130 631 598 599 630 596 571 668 598 822 819
82 80 807 808 809 130 718 132 131 14 599 570 570 571 630 957 822 923 130 599 630 989 599 629 989 599 570 34 630
80 46 839 840 841 67 67 130 70 38 71 99 99 99 599 570 630 946 853 132 2 820 387 926 355 977 978 977 599
103 14 871 872 873 99 99 100 102 38 81 807 808 809 99 132 600 782 783 858 600 780 820 387 387 742 355 355 977
82 6 70 38 71 67 132 130 130 102 103 839 840 841 857 853 599 571 570 630 600 986 851 948 774 513 497 355 387
6 38 82 6 103 99 814 815 989 132 989 871 872 873 132 924 355 853 718 599 605 978 821 986 355 559 545 497 810
38 38 38 143 99 718 846 847 924 926 923 99 989 99 854 387 355 387 926 853 600 946 853 854 355 655 616 496 749
6 38 38 6 71 130 132 978 355 355 355 926 387 926 355 821 820 355 355 821 599 630 946 387 655 616 429 613 616
