53005455
32 32
720 401 199 66 162 204 401 816 845 813 816 401 433 454 488 486 845 427 455 401 752 401 433 401 433 401 452 401 720 401 401 816
752 401 401 209 132 264 816 845 813 816 401 433 401 433 401 433 454 457 401 401 401 433 720 816 817 401 401 433 401 401 816 814
401 295 301 66 198 427 455 454 457 433 401 454 488 486 433 401 433 401 433 401 433 401 816 427 455 452 817 401 433 454 845 846
238 66 66 208 427 457 401 401 816 817 433 401 433 401 454 488 486 457 456 455 401 433 452 457 401 816 454 817 401 720 456 457
66 66 268 262 877 423 401 816 943 941 817 433 401 433 401 401 816 817 401 401 433 816 817 401 816 814 422 879 817 401 401 401
100 198 401 816 845 813 421 973 975 973 974 817 817 401 454 816 427 453 456 433 816 427 486 816 975 973 456 815 849 401 720 752
132 230 401 944 814 427 453 943 427 488 486 457 845 817 401 456 455 877 813 454 488 457 846 452 813 814 974 452 457 817 401 401
164 67 296 848 427 455 848 427 457 877 878 845 813 813 881 814 815 813 845 846 847 877 878 879 456 815 878 845 945 849 454 879
66 162 236 401 944 425 401 848 423 847 909 814 877 813 814 846 847 723 815 813 845 846 722 845 846 452 453 456 426 909 910 456
66 67 198 401 427 457 752 401 944 421 845 846 813 845 846 878 786 846 845 845 877 878 754 877 878 879 814 420 847 941 942 943
202 262 192 816 878 849 401 816 427 457 813 814 815 839 813 910 911 878 879 878 839 910 911 975 723 787 846 814 877 878 420 425
236 401 816 878 849 401 401 427 455 973 845 846 847 847 845 846 847 910 878 878 941 942 943 941 755 879 941 878 909 422 849 144
198 816 427 455 401 720 401 944 425 846 847 845 846 847 845 813 814 815 910 845 846 814 879 910 845 846 941 845 424 849 401 237
456 488 457 401 752 401 816 427 455 878 879 846 878 879 813 845 846 847 942 814 814 846 878 942 877 422 814 846 454 426 297 99
294 337 401 192 401 816 427 453 909 814 839 813 814 815 845 846 847 973 974 813 813 814 815 879 424 816 813 814 420 813 176 203
208 401 192 401 401 427 457 847 815 813 847 845 846 847 877 878 879 941 942 845 845 846 847 945 456 848 845 846 452 426 817 265
99 300 294 401 401 944 425 846 847 845 879 877 878 879 815 877 941 973 974 845 845 839 879 945 877 452 944 845 878 813 815 817
66 202 262 192 433 816 877 878 879 814 911 975 973 815 846 847 973 974 845 846 814 815 815 879 909 424 816 975 973 815 456 455
66 264 401 337 976 911 975 973 815 846 943 941 839 909 910 846 909 814 815 813 814 815 813 814 422 816 849 848 973 974 845 813
208 337 752 337 433 848 845 846 847 845 846 847 846 941 942 878 845 846 847 845 846 847 913 420 816 845 457 456 848 814 815 845
262 295 294 720 337 433 848 421 879 813 814 879 814 846 913 942 877 839 879 846 878 945 401 456 848 849 425 849 454 848 813 877
192 209 67 238 230 192 433 848 425 909 814 722 814 849 401 848 909 814 815 813 847 815 817 401 454 488 457 401 816 452 848 849
238 162 98 99 98 230 192 427 453 847 813 847 787 401 401 401 848 846 975 879 941 942 943 817 401 401 144 294 944 424 401 720
52 197 99 100 99 198 427 457 877 846 845 945 401 401 192 231 296 848 845 846 845 845 975 973 817 401 237 208 422 295 301 230
245 52 117 118 197 230 944 425 975 878 814 945 401 433 297 99 236 401 848 913 846 814 878 879 845 817 199 98 238 162 67 98
213 245 212 22 67 204 848 813 421 973 877 420 977 433 241 66 162 238 300 294 848 846 845 813 814 420 297 67 67 98 99 98
213 213 124 162 67 240 192 848 813 423 424 849 433 192 237 98 119 66 162 208 192 848 975 846 877 456 176 203 162 98 99 130
276 213 245 52 118 298 294 720 848 913 849 401 433 231 98 57 212 52 118 67 238 296 848 913 877 814 977 265 66 162 66 67
212 276 277 212 212 54 162 238 230 295 239 306 231 119 55 244 213 245 212 54 98 234 306 403 848 849 401 192 209 99 131 130
84 85 86 22 27 20 67 162 67 99 162 67 57 212 244 213 213 213 245 124 162 99 98 230 401 192 401 401 199 206 98 99
162 162 162 162 162 66 268 274 199 206 98 99 21 89 276 213 213 213 213 245 58 99 206 198 752 231 300 294 433 401 263 269
162 162 198 275 203 198 752 192 720 433 199 67 67 67 23 276 213 213 277 212 24 208 401 231 238 66 66 198 295 301 230 231
