50005152
28 23
67 1009 1007 1008 1009 1007 1008 67 102 98 135 67 67 641 801 896 749 935 935 748 935 936 877
1007 965 1009 1014 67 1009 1014 67 134 135 67 673 1007 1008 67 805 840 749 747 745 748 747 906
1007 1009 1007 965 67 67 100 101 67 67 673 1014 1009 1014 67 67 896 841 777 899 841 842 899
1009 1007 1009 640 965 673 1007 1008 674 67 704 67 67 67 67 67 803 899 802 67 805 802 67
965 1009 1007 1006 1003 1014 1009 1014 705 67 67 67 67 67 67 67 67 67 67 67 6 10 10
1003 1009 1009 1003 1009 866 67 67 67 67 67 67 67 67 67 67 67 67 206 706 38 42 4
834 866 1009 1014 929 840 836 140 141 67 833 834 67 67 837 836 67 208 723 141 676 67 38
777 808 832 835 840 840 802 720 141 833 840 840 836 833 840 840 834 866 723 143 721 608 674
781 780 874 840 840 804 140 401 721 805 873 809 874 840 840 809 810 865 296 723 295 752 209
872 904 781 874 840 836 720 723 297 835 844 779 780 845 874 777 842 800 720 271 835 836 67
749 872 872 780 844 865 171 723 721 805 841 749 872 780 842 745 865 720 401 753 896 840 836
810 749 872 872 909 874 836 866 171 721 932 777 749 747 842 840 800 230 753 835 840 875 874
876 781 872 936 877 840 840 899 836 723 801 876 842 802 805 802 102 103 67 896 844 780 842
779 872 936 909 874 840 804 67 641 238 67 803 802 137 67 66 134 135 66 801 934 841 842
872 872 748 747 906 840 901 67 67 673 67 6 7 6 7 67 866 866 138 720 139 803 840
749 747 777 778 777 865 67 67 1006 1014 6 4 4 4 41 835 840 840 836 752 723 141 805
805 899 841 842 907 865 1007 1006 1014 6 4 39 38 42 39 803 809 810 865 170 723 237 103
962 67 805 802 801 802 1009 1010 6 4 39 640 643 67 67 835 841 842 840 832 609 100 98
1001 1005 67 641 67 643 67 6 4 39 642 67 67 641 132 805 840 778 840 840 840 836 134
1011 1000 672 677 67 1008 67 40 41 67 674 706 866 67 206 67 805 841 844 874 840 804 723
960 1009 1009 672 1008 1014 6 4 39 67 641 929 840 834 752 141 835 840 939 940 897 720 401
433 273 960 1009 1014 40 4 39 67 770 675 864 840 865 302 721 805 840 841 842 865 270 723
433 433 433 960 67 38 39 67 675 641 1014 864 840 804 720 401 721 805 899 899 802 723 753
433 433 433 433 209 67 67 675 641 643 835 840 865 67 752 723 433 721 209 43 208 753 640
433 433 433 992 1008 672 675 137 673 675 864 840 897 1007 965 300 752 231 6 4 7 642 67
433 433 992 67 1014 674 706 1008 1006 835 840 840 840 834 1009 1007 965 9 4 4 41 1007 67
306 307 67 675 994 994 1009 1009 961 840 840 840 840 802 1007 1009 640 67 38 42 39 1009 1005
67 67 673 1009 1009 1007 706 1008 864 840 840 840 897 739 1009 1007 1007 675 674 962 67 67 1012
