50005152
23 18
451 723 726 727 554 767 724 723 724 552 622 767 726 724 724 724 730 762
723 724 723 723 729 724 723 724 726 491 732 726 724 724 724 724 729 729
724 723 724 724 490 722 724 723 794 491 732 723 724 724 724 729 724 726
724 723 724 723 557 622 722 723 460 585 722 724 723 724 724 724 724 724
723 724 723 794 491 732 723 724 723 723 723 723 724 723 724 726 724 729
458 494 546 494 585 722 724 177 295 304 301 230 723 552 494 461 735 726
729 723 723 723 723 753 301 833 836 833 834 198 729 491 732 729 726 724
723 724 177 231 300 235 135 896 809 874 865 296 723 491 732 726 729 729
726 297 833 898 834 67 837 779 781 780 897 720 723 491 722 724 724 723
724 265 805 808 810 898 779 903 872 909 865 236 723 491 732 723 723 724
723 729 205 801 876 938 749 935 936 968 780 834 588 525 722 724 723 724
724 723 265 103 803 933 934 902 876 749 747 940 832 584 458 494 546 494
723 724 726 145 263 269 269 67 803 777 778 906 899 901 204 756 723 760
458 458 553 735 729 723 723 199 67 801 899 804 132 137 264 724 724 726
756 727 584 457 489 735 724 753 299 102 132 198 263 262 724 726 730 724
724 726 762 584 458 458 459 161 134 105 204 723 724 724 490 735 724 729
724 724 730 729 726 205 835 898 832 100 234 306 724 723 491 732 724 726
724 724 726 724 724 265 803 939 810 836 134 162 296 724 557 494 735 588
461 735 724 490 735 176 136 896 779 780 836 100 264 724 491 732 730 762
761 724 724 491 732 724 199 801 902 458 458 458 732 723 491 722 724 726
729 724 724 584 553 732 434 263 272 262 729 724 724 723 523 732 723 724
730 729 726 724 491 732 729 724 724 723 724 723 724 724 491 722 724 723
724 724 724 726 554 732 724 723 724 724 724 724 723 724 523 732 724 724
