1800481a
10 15
424 551 426 426 426 426 426 426 426 426 426 426 426 550 424
424 489 646 583 867 866 861 862 863 867 866 583 646 488 424
425 457 584 616 899 892 893 894 895 891 740 615 583 456 425
425 489 616 648 874 924 925 926 927 923 903 647 615 488 425
424 457 648 966 583 876 596 625 628 842 583 966 647 456 424
424 489 966 849 615 876 688 627 689 842 615 851 967 488 424
425 457 851 583 648 452 454 454 454 453 647 583 851 456 425
424 425 457 615 966 849 849 849 849 849 967 615 456 425 424
425 425 489 647 851 849 849 849 849 849 849 647 488 425 425
425 425 425 425 457 851 849 849 849 849 456 425 425 425 425
