1800b91a
21 20
841 586 873 844 586 877 148 522 746 746 746 746 521 214 520 746 746 746 746 746
841 484 876 841 484 876 180 554 874 843 844 844 552 426 553 874 843 844 844 423
842 839 452 453 839 876 183 554 876 841 842 841 843 844 844 842 841 841 841 519
182 537 182 182 537 182 276 554 876 842 841 841 520 426 521 877 841 841 841 519
213 213 213 213 213 213 276 552 484 877 841 484 464 814 554 876 842 842 841 554
841 842 841 841 841 183 276 780 839 452 453 839 782 148 552 484 417 418 484 464
841 520 746 521 877 183 276 182 569 570 182 569 570 180 780 839 452 453 839 782
841 554 874 554 877 183 213 213 276 841 841 183 213 213 182 569 570 182 569 570
842 552 451 553 876 183 213 213 276 841 842 183 213 213 276 841 841 842 841 183
841 843 843 843 841 183 213 213 276 182 182 276 213 213 276 842 842 841 841 183
182 182 182 182 182 276 276 276 276 212 212 276 276 213 276 841 842 841 842 841
276 276 276 520 746 521 183 276 841 841 842 842 183 213 276 842 841 842 841 841
842 841 183 491 33 554 183 276 841 842 419 842 183 213 276 841 841 842 841 214
842 841 183 484 451 484 183 276 842 841 841 842 183 213 276 842 842 841 841 183
841 841 183 714 451 714 183 276 841 842 841 842 183 276 276 182 182 182 182 276
182 182 276 839 451 839 184 276 182 182 182 182 276 841 520 746 746 746 521 877
213 213 213 569 570 569 277 213 213 213 213 213 276 841 459 874 419 844 554 877
276 276 276 276 276 276 276 213 213 213 213 213 276 842 491 877 841 842 554 876
841 842 841 842 841 183 276 276 276 276 276 213 276 841 484 876 841 841 484 877
841 842 841 841 841 183 841 842 841 842 841 183 276 842 839 452 454 453 839 876
842 841 841 841 841 183 842 841 842 841 841 183 276 841 871 843 844 844 871 812
