1800191a
10 15
277 213 213 213 213 277 212 212 217 877 842 218 213 213 245
213 520 426 426 426 426 484 430 484 877 842 484 433 493 183
213 459 867 866 866 866 679 867 742 877 842 742 867 458 183
276 491 963 960 960 960 386 825 826 858 821 826 825 458 183
212 459 823 825 824 825 422 821 821 822 821 821 822 458 183
212 491 820 821 822 822 422 821 822 821 821 821 822 458 183
244 459 820 821 821 821 520 426 426 426 426 426 426 583 183
277 491 820 821 822 821 459 867 866 866 866 866 866 615 183
565 583 820 821 821 821 583 963 960 961 960 961 960 711 563
665 615 820 821 821 822 615 631 756 665 756 665 756 665 762
