8800898a
21 21
18 175 178 74 75 76 178 174 18 207 259 206 18 207 259 206 18 18 18 18 18
18 432 115 74 75 76 114 408 435 435 435 435 178 408 435 435 435 435 435 178 18
18 338 145 6 6 6 144 6 6 6 6 6 142 528 529 529 529 529 529 338 18
18 338 7 5 5 5 5 5 5 5 5 5 110 8 6 6 6 6 6 338 18
18 338 7 5 5 5 5 5 5 5 5 5 110 7 5 5 5 5 5 338 18
18 338 7 5 5 5 5 5 5 5 5 5 110 7 5 5 5 5 5 338 18
18 338 7 5 5 5 5 5 5 432 498 435 435 435 435 435 435 433 7 338 18
18 406 500 500 500 500 178 344 500 178 528 529 529 529 529 529 529 338 7 338 18
18 338 521 224 230 521 114 224 230 115 8 6 6 6 6 6 6 338 7 338 18
18 338 489 256 262 489 114 256 262 173 271 5 15 7 15 7 5 338 7 338 18
18 338 395 466 468 395 173 241 273 46 5 5 47 39 47 39 5 338 7 338 18
18 338 177 273 241 273 46 240 240 46 5 5 5 5 5 5 5 338 7 338 18
18 338 176 240 240 272 46 272 240 46 5 5 15 7 15 7 5 338 7 338 18
18 338 208 272 240 272 46 240 272 46 5 5 47 39 47 39 5 338 7 338 18
18 338 176 240 272 240 46 272 240 46 5 5 5 5 5 5 5 338 7 338 18
18 338 176 240 240 272 46 240 272 46 5 5 15 7 15 7 5 338 7 338 18
18 338 208 272 272 240 46 272 240 46 5 5 47 39 47 39 5 178 7 338 18
18 338 176 240 272 272 432 500 500 500 373 7 5 5 5 5 5 82 7 338 18
18 486 208 272 240 240 338 248 392 231 338 7 5 5 5 5 5 5 5 338 18
18 194 178 74 75 76 178 196 391 101 178 344 500 178 344 500 178 344 500 178 18
18 226 114 74 75 76 114 174 361 362 114 392 231 114 392 231 114 392 231 114 18
