8800898a
22 23
338 74 75 75 76 338 529 529 565 529 529 529 529 529 114 529 529 529 529 529 529 338 18
338 74 75 75 76 338 8 6 563 8 68 8 68 8 82 8 6 6 6 68 8 338 18
338 74 75 75 76 338 7 5 6 5 6 5 6 5 5 5 5 5 5 6 5 338 344
338 8 6 6 6 565 7 5 434 435 435 341 498 435 435 562 7 432 562 7 434 373 392
338 7 5 5 5 563 7 5 560 529 529 338 528 529 529 561 7 338 564 7 560 338 344
338 7 5 5 5 6 5 5 6 6 6 338 8 6 6 6 5 338 8 5 6 338 392
338 7 5 5 432 498 435 341 498 562 7 434 341 498 562 7 434 435 435 435 435 373 399
338 7 5 5 338 528 529 371 528 561 7 560 338 528 561 7 560 529 529 529 529 338 330
371 178 7 178 565 8 6 338 8 6 5 6 338 8 6 5 6 6 6 6 6 338 18
338 115 7 114 563 7 5 338 7 5 432 498 435 562 7 435 341 562 7 435 435 373 18
338 145 271 144 6 5 5 338 7 5 338 528 529 561 7 529 338 561 7 529 529 338 18
338 7 5 5 406 498 435 562 7 5 338 8 6 6 5 6 338 8 5 6 6 338 18
338 7 5 5 338 528 529 561 7 5 338 7 5 434 435 435 435 435 435 562 7 338 18
338 7 5 5 338 8 6 6 5 5 338 7 5 560 529 529 529 529 529 561 7 338 344
338 7 5 5 338 7 5 406 498 435 373 7 5 6 6 6 6 6 6 6 5 338 392
371 178 7 178 310 7 5 338 528 529 406 498 435 435 435 435 373 7 5 5 5 338 344
338 115 7 114 565 7 5 565 8 6 565 528 529 529 529 529 434 435 562 7 435 373 392
338 145 271 144 563 7 5 563 7 5 563 8 6 6 6 6 560 529 561 7 529 338 399
338 7 68 7 6 5 5 6 5 5 6 5 5 5 5 5 6 6 6 5 6 338 330
338 7 6 5 338 7 5 338 7 5 338 7 5 5 5 5 338 7 5 5 5 338 18
178 344 500 500 500 500 500 500 178 344 500 500 500 500 500 500 178 74 75 75 76 178 18
114 392 393 393 393 393 393 393 114 392 393 393 393 393 393 393 114 74 75 75 76 114 18
