8800898a
23 21
18 425 224 230 183 224 230 424 365 74 75 76 366 425 224 230 183 224 230 424 18
18 263 256 262 215 256 262 266 102 74 75 76 106 263 256 262 215 256 262 266 18
18 295 288 289 247 357 358 298 167 74 75 76 170 295 288 289 247 357 358 298 18
18 18 322 487 114 322 487 135 136 177 273 273 137 138 322 487 114 322 487 18 18
18 18 418 519 114 418 519 167 168 176 15 176 169 170 418 519 114 418 519 18 18
18 178 440 435 435 435 433 199 200 176 48 209 201 202 432 498 435 435 435 178 18
18 338 528 529 529 529 338 392 167 176 272 240 170 392 338 528 529 529 529 338 18
18 338 8 6 6 6 338 135 136 176 240 272 137 138 338 8 6 6 6 338 18
18 338 7 434 373 7 338 167 168 176 15 176 169 170 338 7 5 5 5 338 18
18 338 7 560 338 7 338 199 200 176 48 209 201 202 338 7 15 15 7 338 18
18 338 7 6 338 7 338 392 167 176 272 240 170 392 338 7 47 47 39 338 18
18 406 436 7 338 7 338 426 160 172 208 171 166 266 338 7 5 5 5 338 18
18 338 561 7 338 7 338 295 192 193 13 197 198 298 338 7 178 301 5 338 18
18 338 8 5 338 7 178 18 362 37 37 37 361 18 178 7 434 373 7 338 18
18 338 7 434 433 7 82 301 5 5 5 5 5 5 82 7 560 338 7 338 18
18 338 7 560 338 7 5 5 432 498 435 435 433 5 5 5 6 338 7 338 18
18 338 7 6 533 435 435 435 534 528 529 529 533 435 435 435 435 534 7 338 18
18 338 7 5 560 529 529 529 561 8 6 6 560 529 529 529 529 561 7 338 18
18 338 7 5 6 6 6 6 6 5 5 5 6 6 6 6 6 6 5 338 18
18 338 7 5 432 500 500 500 178 74 75 76 178 344 500 500 433 301 5 338 18
18 178 344 500 178 392 522 523 114 74 75 76 114 525 523 392 178 344 500 178 18
18 114 392 393 114 424 554 555 114 74 75 76 114 557 555 424 114 392 393 114 18
18 114 424 425 114 424 320 326 114 74 75 76 114 384 326 424 114 424 425 114 18
