8800898a
18 15
418 419 420 514 515 338 74 75 76 338 519 544 418 419 420
432 306 306 178 312 465 74 75 76 464 306 178 312 340 433
338 8 6 114 8 6 241 273 273 6 6 114 8 6 338
338 7 5 144 271 15 208 240 272 15 7 144 271 5 338
338 7 5 178 7 47 209 272 272 47 271 178 7 5 338
338 7 5 114 7 5 272 240 272 5 5 114 7 5 338
338 7 5 144 271 15 208 272 272 15 7 144 271 5 338
338 7 5 5 5 47 209 272 272 47 271 5 5 5 338
336 470 499 178 7 5 272 272 240 5 5 178 312 469 337
336 369 532 141 271 15 208 272 272 15 7 142 530 336 369
368 369 177 46 5 47 209 272 272 47 271 110 177 336 369
432 499 208 178 310 7 272 240 272 5 432 178 208 434 373
338 532 208 114 501 502 208 272 240 501 502 115 208 466 338
338 177 240 146 459 460 74 75 76 459 460 147 240 273 338
464 433 208 272 256 492 74 75 76 256 492 208 272 432 465
423 484 337 208 273 241 273 241 273 241 273 272 336 485 455
423 194 178 312 306 178 208 272 272 178 312 306 178 196 455
423 226 520 522 523 520 74 75 76 520 522 523 520 174 455
