8800898a
23 24
114 408 435 178 18 18 18 178 130 323 132 178 18 18 18 18 98 291 100 18 18 18 18 18
143 528 529 114 18 18 18 114 333 6 334 114 18 139 64 64 130 323 132 64 64 140 18 18
110 8 6 144 37 37 37 144 271 5 5 144 37 178 391 101 333 6 334 101 101 178 18 18
110 7 5 5 37 37 37 5 5 5 5 5 37 114 8 6 5 5 5 6 6 114 18 18
178 344 500 178 18 18 18 178 7 5 5 178 37 144 271 5 5 5 5 5 5 144 37 37
115 229 230 114 18 18 18 199 162 7 164 202 37 5 5 5 5 5 5 5 5 5 37 37
115 261 262 360 18 18 18 231 194 195 196 234 18 178 7 5 5 5 5 5 5 178 18 37
115 325 326 298 18 18 18 263 103 104 174 266 18 160 64 64 162 7 164 64 64 166 18 37
115 389 390 18 18 18 18 295 258 259 206 298 18 192 192 192 194 195 196 391 192 198 18 37
115 421 422 98 291 100 18 18 418 419 420 18 18 362 448 449 103 104 174 98 291 100 18 37
139 161 64 130 323 132 64 161 140 18 18 18 18 327 416 417 258 259 178 130 323 132 178 37
167 391 101 333 6 334 101 101 178 18 18 18 18 18 18 18 418 419 114 333 6 334 114 37
167 8 6 5 5 5 6 6 114 18 18 18 18 18 18 18 18 37 144 271 5 5 144 37
167 7 5 5 5 5 5 5 144 37 18 18 18 18 18 18 18 37 5 5 5 5 5 37
167 7 5 5 5 5 5 5 5 37 18 18 98 291 100 18 18 37 5 5 5 5 5 37
160 161 162 7 5 5 164 161 178 37 178 64 130 323 132 69 178 37 178 162 7 164 178 18
552 192 194 279 45 279 196 391 552 37 114 391 333 6 334 101 114 37 115 194 195 196 115 18
263 416 258 195 45 195 174 422 266 37 144 6 5 5 5 6 144 37 359 103 104 174 360 18
295 432 498 562 45 434 435 433 298 37 5 5 5 5 5 5 5 37 295 258 259 206 298 18
18 339 528 561 45 560 529 339 18 37 5 5 5 5 5 5 5 37 18 418 419 420 18 18
18 339 8 6 6 6 6 338 18 18 178 281 162 7 164 282 178 18 18 18 18 18 18 18
18 339 7 5 5 5 5 371 18 18 115 391 194 195 196 198 115 18 18 18 18 18 18 18
18 501 502 74 75 76 500 502 18 18 115 391 103 104 174 198 115 18 18 18 18 18 18 18
