a700a8a9
29 17
745 749 780 834 680 523 495 496 497 498 499 523 679 67 801 745 749
845 779 909 931 552 516 527 528 529 530 531 516 464 65 835 779 780
749 747 902 802 516 580 559 560 561 562 563 580 516 733 803 749 748
745 802 67 67 580 695 696 689 690 691 697 697 580 733 103 864 808
931 67 137 208 697 694 693 694 694 694 693 693 697 199 104 803 779
810 834 459 546 492 493 459 461 732 588 493 459 458 546 461 869 813
842 897 758 726 724 523 732 724 724 724 522 128 726 545 701 896 749
804 805 838 724 724 523 732 459 459 461 835 806 724 577 835 875 842
102 198 724 723 724 523 732 726 726 790 932 838 724 723 803 934 804
145 460 458 459 458 459 459 458 553 732 523 96 726 724 275 272 262
726 724 724 723 724 724 724 726 523 732 584 459 458 459 553 732 724
459 459 459 459 459 459 461 732 523 732 724 724 724 307 522 128 724
724 726 788 723 726 724 726 723 523 732 724 723 231 833 841 836 270
726 231 866 460 458 458 459 458 459 461 722 459 459 868 899 897 723
723 835 745 838 723 788 788 788 788 723 788 723 788 757 199 928 723
790 803 802 759 792 837 834 837 832 866 866 866 835 806 724 490 732
723 523 160 792 837 809 906 844 938 777 844 781 780 838 723 523 722
724 523 733 900 899 800 803 934 804 803 933 902 902 901 144 523 722
724 523 732 756 756 723 199 132 198 723 756 756 756 756 726 523 732
724 584 459 553 732 726 552 459 458 459 459 459 458 459 459 585 722
724 724 724 523 732 723 523 732 724 723 724 724 545 734 726 545 734
724 544 732 523 722 724 523 732 723 724 724 788 577 732 724 577 732
724 576 766 523 732 724 584 459 459 459 553 774 866 230 724 724 724
724 726 724 522 128 726 724 724 724 726 523 780 874 834 144 726 724
458 461 732 869 834 552 459 461 732 459 585 749 780 810 758 460 458
726 724 790 932 802 490 732 726 724 724 176 803 902 802 758 723 724
724 724 790 803 901 584 553 732 724 724 552 461 160 756 724 724 724
724 490 732 756 756 724 584 553 732 552 585 732 724 724 724 490 732
552 585 732 724 724 726 724 584 458 585 732 724 724 726 724 584 494
