FE8 - Mountainous - 6c006d6e
30 30
0 536 972 0 443 907 1007 1007 1007 1007 900 943 807 848 439 807 901 943 601 604 638 597 881 872 873 943 911 807 943 1007
907 905 1004 876 0 970 807 943 1007 900 774 943 776 880 33 38 1007 901 628 638 638 605 1006 374 907 943 1006 807 942 1007
970 0 0 908 807 882 695 943 900 774 970 999 372 38 38 38 837 974 901 636 638 605 1006 911 774 943 64 820 798 942
914 504 503 940 0 779 875 943 911 911 911 911 911 38 38 38 907 1007 971 636 636 638 597 506 905 944 701 702 905 878
1006 1006 502 0 807 374 373 943 6 6 6 443 1006 1007 1006 1007 900 907 905 943 636 638 638 597 937 976 668 978 937 964
443 0 501 0 869 974 911 774 774 774 774 774 774 662 774 805 907 970 937 943 636 157 158 638 914 1008 1009 1010 888 911
135 141 0 882 881 1006 1007 911 911 932 911 911 870 878 879 907 970 974 933 964 638 124 125 633 633 773 943 1006 874 810
0 943 807 943 992 1006 807 943 1006 1007 6 1007 0 911 911 937 882 945 888 911 638 638 638 629 0 774 943 1007 807 974
807 943 695 943 1007 1007 807 942 805 943 1006 1006 567 1007 907 970 943 1006 1 472 638 638 629 65 65 871 943 774 905 779
807 943 807 943 774 943 807 943 0 943 1007 1006 567 0 970 974 1007 1006 911 471 2 2 0 66 65 911 1007 903 970 870
0 1007 904 943 906 1006 804 805 943 900 869 943 567 944 701 702 702 1006 66 636 638 471 79 79 135 992 98 911 911 911
440 797 843 774 774 774 725 772 0 0 911 1006 567 976 668 978 978 948 660 638 471 638 638 0 38 135 98 98 1006 939
725 805 974 0 871 871 836 772 837 999 807 943 567 1008 1009 1010 66 1011 636 638 471 1006 638 638 6 6 443 1007 65 971
836 726 777 870 871 871 776 725 837 942 932 903 725 772 805 943 774 660 638 471 774 943 911 638 638 6 135 98 992 65
772 805 405 974 911 911 911 804 837 943 911 911 776 774 774 777 638 638 638 1006 871 943 907 905 638 638 6 71 443 1006
772 837 974 65 507 1007 1007 804 837 774 0 0 378 378 378 347 638 804 805 943 911 1007 970 970 943 638 34 34 638 905
774 905 943 944 701 702 1006 804 837 774 379 347 471 638 638 638 440 804 805 943 1007 1007 911 914 945 871 903 6 638 638
967 937 942 976 668 978 1007 804 837 347 471 439 440 900 789 789 789 789 789 884 1007 774 943 1007 65 911 911 911 64 638
65 0 1007 1008 1009 1010 1007 905 347 440 440 797 774 853 70 1012 1012 1012 1012 66 98 911 507 65 506 70 6 6 71 59
0 1007 1006 1007 1007 905 905 937 471 797 774 853 974 0 1012 70 70 70 70 79 135 78 98 442 443 102 111 167 173 23
339 1006 1007 1007 1007 970 970 970 440 807 1007 1007 911 911 64 64 98 70 38 6 6 6 475 162 507 98 1006 0 0 57
0 0 942 804 837 974 911 911 2 1007 1007 1007 1007 1007 1007 1007 66 104 0 905 910 694 774 905 102 443 804 773 870 0
810 694 774 774 774 943 906 911 2 1007 1007 1007 1007 1007 1007 1006 1006 98 0 937 980 0 871 937 884 65 797 774 907 0
372 400 373 974 911 1007 1006 807 440 0 804 805 974 1006 1006 1007 1007 1007 410 1003 975 0 911 888 1006 1007 806 871 807 943
911 911 911 1006 1006 65 474 347 471 943 779 774 907 943 868 725 772 772 772 772 772 772 726 777 943 1007 905 871 932 808
943 1007 1006 806 943 907 347 471 881 1007 372 871 807 942 911 804 772 772 772 772 772 772 837 974 507 1007 937 0 870 871
943 1006 1006 806 943 347 471 774 777 943 911 911 776 798 942 804 773 726 774 774 774 774 777 943 1006 1006 888 0 0 0
1006 65 1007 797 806 806 471 471 911 774 901 943 911 806 943 804 773 837 870 871 278 279 373 943 1007 1006 1007 942 474 296
64 98 1006 806 797 797 806 471 347 906 804 772 726 774 774 725 773 837 974 911 64 911 911 1006 1007 1006 911 1006 1006 328
1006 1007 1007 347 806 806 347 471 471 347 378 772 837 870 871 804 773 773 943 1006 1007 776 942 1007 1007 65 900 774 943 1008
