7b007c7d
16 22
909 910 975 846 878 911 877 878 879 877 817 433 401 265 100 100 100 110 100 110 10 108
941 942 817 877 815 943 941 942 877 945 877 977 433 434 205 100 100 100 100 138 9 10
910 911 814 975 839 977 814 909 423 846 846 877 816 401 201 203 130 100 100 108 41 42
974 975 846 941 975 814 815 942 973 423 846 881 411 433 433 303 162 100 100 100 171 100
975 975 722 941 877 878 879 909 910 973 423 877 816 817 411 201 272 269 100 162 163 100
941 942 754 977 814 815 943 974 813 814 814 815 910 975 877 817 433 401 273 195 162 100
973 877 424 879 814 815 975 909 941 848 878 973 942 943 910 911 912 912 433 433 209 163
817 424 879 975 847 975 848 849 813 814 815 973 974 975 845 846 877 877 817 401 199 100
424 814 815 911 910 975 787 723 877 847 909 943 424 814 877 878 879 849 433 433 231 100
845 877 878 878 942 943 848 849 815 941 881 424 813 813 814 815 975 401 433 337 227 198
845 846 847 813 974 975 424 423 944 945 424 815 813 845 846 847 846 877 433 411 401 337
877 878 813 910 911 420 845 975 423 424 877 878 879 877 879 909 910 880 881 912 411 433
909 813 941 942 943 975 910 909 975 975 943 427 455 452 426 813 814 943 973 974 975 433
846 814 909 974 975 977 942 943 845 846 427 453 904 976 877 910 973 911 941 942 845 433
878 815 941 817 880 944 846 814 815 941 975 421 975 945 975 813 814 909 910 911 877 845
846 847 813 909 912 976 877 878 847 973 427 453 977 878 879 877 878 941 942 943 877 878
