21002223
24 26
194 727 288 727 194 761 696 794 458 452 453 426 592 427 452 453 459 2 793 696 762 194 727 132 793 665
761 794 172 793 696 794 140 72 458 528 595 657 623 528 595 657 459 2 134 135 793 696 794 66 132 793
794 132 463 426 426 426 426 460 493 560 690 659 595 658 691 689 525 462 426 426 426 426 521 1 132 99
132 194 459 65 723 722 754 722 490 720 596 625 625 625 628 753 490 723 722 754 722 722 459 2 194 761
762 288 491 723 593 597 594 721 722 721 688 690 625 691 689 721 722 721 593 597 594 721 459 2 132 793
794 102 458 720 721 753 721 721 458 752 721 596 625 628 721 721 458 720 721 753 721 721 459 2 132 72
463 426 426 426 426 521 720 428 426 426 426 429 531 628 428 426 426 426 429 720 463 426 426 426 426 521
459 723 754 722 754 459 496 435 595 595 595 595 658 659 595 595 595 595 436 594 459 823 824 824 825 459
491 720 656 657 721 490 720 532 627 627 627 627 627 627 627 627 627 627 437 721 490 820 65 820 821 459
459 752 688 689 753 722 593 501 463 426 426 484 784 785 484 430 426 521 434 594 722 821 824 65 820 459
491 720 721 721 721 458 720 626 459 518 517 516 452 453 516 518 517 459 495 721 458 820 65 823 821 459
525 462 426 426 460 493 720 626 459 2 761 696 724 724 696 762 72 491 495 721 525 462 426 426 460 493
459 723 722 754 722 459 720 626 459 2 727 131 793 794 131 727 102 458 495 753 459 823 824 824 825 459
458 720 65 720 721 490 752 626 459 2 793 696 731 731 696 794 72 491 495 721 490 820 821 65 820 459
459 752 722 721 721 722 593 501 552 426 426 521 630 730 463 426 426 553 466 594 722 821 821 824 821 459
459 752 65 720 721 458 752 500 595 657 722 459 662 730 458 723 656 595 469 721 458 820 65 820 821 459
491 720 722 721 721 459 496 467 627 689 721 459 662 730 458 720 688 627 468 594 459 820 824 821 821 459
484 430 460 431 427 427 429 720 463 484 720 484 662 730 484 752 484 431 462 720 428 460 431 462 426 484
518 517 517 459 723 722 754 721 459 516 420 516 694 730 516 420 516 459 723 721 754 722 459 518 517 516
102 103 166 459 720 656 657 721 459 2 727 110 729 730 110 727 102 459 720 656 657 753 459 2 102 103
762 66 70 459 720 688 689 753 491 2 793 731 724 724 665 724 762 491 752 688 689 753 459 2 162 761
724 762 102 491 419 753 721 721 458 2 99 729 724 697 724 724 794 459 720 753 721 419 459 2 761 724
724 794 70 484 430 427 427 426 484 2 761 724 794 99 793 794 76 484 430 426 427 426 484 2 793 724
794 70 6 516 518 517 517 517 516 34 793 794 140 72 71 132 136 516 518 517 517 517 516 34 131 793
