1c1d1e1f
16 17
803 866 66 802 592 785 783 720 66 720 784 785 66 720 133 70 6
835 161 66 834 161 66 815 66 784 785 66 782 685 67 70 6 38
79 135 14 131 162 163 133 783 66 782 685 684 653 99 102 38 6
166 38 169 202 274 199 684 815 680 681 688 685 782 782 162 102 38
782 102 103 240 433 401 199 804 679 557 712 685 720 66 162 44 38
711 720 162 236 295 294 434 199 676 748 560 679 653 783 720 44 6
903 904 905 674 772 133 230 433 205 674 775 744 688 815 66 782 102
935 936 937 679 66 932 720 144 265 782 626 651 688 653 784 785 66
967 968 969 711 742 99 783 230 393 209 64 748 719 686 685 783 66
679 331 684 626 513 561 815 782 363 66 198 469 626 545 712 688 66
711 66 782 685 559 623 497 900 720 204 401 436 471 748 560 679 684
711 720 66 685 685 748 613 651 745 264 433 233 301 65 674 65 66
64 66 66 66 684 654 559 622 719 270 433 237 932 162 100 66 66
804 836 66 163 14 684 685 751 65 230 179 71 99 98 67 720 782
720 66 131 70 6 135 75 64 932 66 174 143 720 163 162 98 99
98 74 134 6 38 6 73 804 66 74 72 6 71 66 782 130 131
