1c1d481f
17 28
460 428 613 417 717 494 590 720 807 808 809 66 100 99 164 14 66 600 782 131 102 103 361 782 66 395 66 66
492 465 559 459 465 784 785 66 839 840 841 67 67 99 76 6 71 2 14 720 14 66 804 804 208 177 145 199
494 592 684 748 592 720 131 395 871 872 873 67 67 677 70 6 80 600 112 82 6 71 676 773 505 473 231 230
720 66 720 67 99 99 720 805 337 293 131 99 677 499 142 167 107 696 102 103 102 103 131 99 230 401 145 199
860 861 862 99 198 263 391 771 672 773 675 771 782 70 6 71 99 599 570 570 630 198 275 269 198 433 401 433
892 893 894 98 238 230 231 70 82 79 71 70 71 102 38 143 67 70 103 388 2 231 230 401 433 305 177 231
924 925 926 14 99 99 99 112 6 6 114 114 103 720 168 103 99 102 71 99 600 131 99 230 297 66 66 131
71 70 82 6 79 71 67 720 102 143 720 720 14 100 70 80 720 70 103 131 564 99 162 57 248 269 395 164
114 6 6 6 6 143 720 130 70 6 45 44 6 82 167 107 131 46 131 66 636 54 57 244 245 347 350 54
70 6 38 103 102 103 99 67 102 103 720 70 114 103 784 785 208 199 116 53 212 212 244 213 213 245 244 245
102 6 6 71 131 99 131 99 640 99 76 143 720 164 198 199 206 144 215 212 244 213 213 213 213 213 213 213
118 46 102 103 720 99 99 99 672 773 99 102 71 164 144 401 316 316 247 244 213 213 277 213 276 213 213 213
212 54 119 99 720 807 808 809 164 900 676 44 6 77 230 316 316 247 244 213 213 277 283 212 216 217 276 277
245 245 124 720 66 839 840 841 99 361 163 836 104 77 53 347 350 244 213 213 277 216 304 217 54 57 212 214
213 277 124 67 66 871 872 873 131 202 267 331 72 77 125 244 213 277 276 277 216 299 868 236 217 212 26 869
213 245 245 54 66 132 366 367 268 200 265 70 103 53 244 213 277 216 217 213 248 207 272 207 249 213 54 296
213 213 245 124 132 132 292 145 401 433 231 103 53 212 213 213 214 868 234 217 213 347 348 349 244 213 28 392
