1c1d621f
23 17
212 213 213 245 212 276 277 276 213 277 212 212 212 276 213 213 213
276 213 277 84 85 86 309 212 283 315 212 24 23 212 276 213 277
212 315 214 209 99 141 23 214 401 297 600 99 198 215 315 212 212
214 401 231 99 70 6 71 300 239 235 2 71 300 294 307 604 84
179 238 99 720 102 114 103 720 99 596 629 112 71 99 596 629 14
174 82 45 70 71 720 99 140 141 599 630 102 103 99 2 70 6
720 42 782 113 6 71 720 112 38 71 599 597 99 596 629 102 38
134 38 82 6 38 103 99 102 114 103 162 604 602 629 99 70 6
102 111 111 173 110 99 720 99 782 99 596 635 605 75 720 142 6
720 99 106 70 82 45 163 99 596 570 629 112 2 109 99 782 38
99 631 570 34 34 597 99 3 36 101 782 110 628 597 99 99 104
570 629 99 932 932 628 630 3 36 101 99 720 99 599 597 99 108
15 71 99 720 46 99 628 539 605 99 99 99 782 99 604 34 538
38 80 783 99 99 720 163 12 600 7 720 720 99 596 629 99 720
111 103 99 99 782 163 163 163 628 39 597 99 631 598 720 815 99
720 99 720 99 99 99 163 99 99 11 628 539 629 99 817 99 99
720 99 99 720 99 99 99 720 99 99 99 720 99 848 849 99 785
497 720 99 784 99 99 99 720 99 99 99 99 815 99 782 99 99
576 561 720 99 720 99 720 99 817 99 849 99 720 816 817 99 815
584 617 529 99 720 99 99 848 99 99 720 782 783 848 849 782 720
582 545 496 815 99 99 720 99 782 782 99 783 815 99 782 720 721
545 581 427 561 720 99 99 720 99 783 720 815 784 99 785 721 723
425 586 547 545 497 99 815 784 785 815 783 99 720 720 753 787 722
