1c1d1e1f
25 19
491 492 460 492 592 720 976 942 977 102 6 103 641 142 6 137 807 808 809
495 544 428 465 685 67 973 974 975 70 6 466 769 142 6 143 839 840 841
495 520 544 460 497 99 1005 1006 1007 102 103 677 499 172 166 103 871 872 873
495 587 454 428 496 783 98 331 163 14 675 229 782 196 675 499 100 270 275
495 523 416 717 528 66 163 162 70 169 641 70 45 641 70 79 71 361 230
495 416 618 428 528 672 773 44 6 137 868 143 196 769 142 6 169 100 100
524 616 428 460 496 98 783 768 102 6 868 103 677 70 114 6 71 720 100
524 545 492 492 496 721 815 720 70 81 772 769 229 47 720 113 6 71 70
495 491 428 492 592 684 721 67 102 114 71 99 100 769 70 6 103 102 103
559 619 544 492 497 720 70 82 71 70 143 782 801 782 102 103 784 785 631
591 587 422 492 465 804 102 38 103 142 103 100 229 100 98 98 70 631 629
583 417 618 553 545 497 70 81 206 46 815 132 631 34 538 570 34 629 100
492 618 716 551 424 528 102 103 366 367 44 631 629 100 130 98 46 162 163
545 496 996 559 746 592 208 273 369 784 785 600 807 808 809 100 100 100 70
748 592 784 785 163 775 777 270 231 720 98 601 839 840 841 100 100 804 142
70 38 804 71 202 207 869 401 209 742 673 600 871 872 873 268 262 390 142
102 114 103 46 264 401 177 869 655 616 719 632 162 292 273 305 231 100 142
199 198 199 66 230 176 67 591 616 528 631 598 130 131 361 162 720 70 6
305 231 230 263 262 433 199 495 545 496 664 626 625 130 70 79 82 6 6
70 79 71 144 433 295 301 495 616 528 632 493 617 529 142 6 6 6 6
6 6 103 230 231 782 14 495 545 465 601 752 544 560 102 6 6 6 6
111 81 720 70 79 79 143 559 459 592 696 559 459 593 782 102 103 102 103
100 102 82 6 114 6 143 65 751 41 600 493 558 900 900 71 131 131 133
45 782 113 103 782 102 6 71 64 35 600 13 65 102 6 6 71 836 782
79 82 6 71 268 274 147 111 82 71 632 99 130 131 142 6 836 6 82
