10007312
15 26
160 161 419 585 586 512 513 578 419 875 611 612 613 419 672 609 674 230 740 741 742 875 7 234 240 302
458 419 67 578 419 458 743 744 747 907 643 644 645 578 704 641 706 236 772 773 774 907 77 416 142 302
877 878 877 877 813 581 775 997 779 875 578 426 488 554 160 519 160 198 548 267 128 875 39 448 161 230
460 133 160 161 907 521 549 584 419 907 160 160 160 521 555 580 555 516 484 452 427 907 43 161 419 198
460 452 457 554 908 556 814 877 878 815 877 878 912 521 522 911 877 912 460 582 911 845 553 457 548 484
864 865 738 741 742 460 611 612 613 907 743 744 747 460 165 614 615 616 230 452 518 548 452 489 484 452
896 897 770 773 774 460 643 644 645 908 775 776 779 460 133 646 647 648 236 484 484 484 522 419 585 489
484 452 518 484 516 516 484 518 516 197 196 484 516 484 516 207 516 133 198 516 516 580 586 36 419 192
740 741 737 865 866 460 452 484 516 452 484 452 484 484 518 580 580 484 516 518 516 875 11 160 4 11
772 773 769 897 898 460 484 516 518 812 877 877 880 521 582 812 877 877 880 460 484 875 7 161 419 303
484 452 452 484 516 452 452 484 516 907 743 744 747 460 522 907 740 741 742 460 522 907 110 11 138 302
550 452 864 865 866 460 608 609 610 875 775 997 779 460 582 875 772 773 774 460 165 875 78 419 168 240
521 484 896 897 898 460 640 641 642 908 553 516 516 484 516 907 553 516 518 484 133 907 39 128 140 419
585 580 518 484 452 452 452 484 516 520 580 586 297 228 586 875 585 484 452 580 586 875 419 132 302 207
877 878 877 878 877 878 877 877 878 878 877 878 877 878 878 877 878 877 878 877 877 845 109 271 302 229
