1000ea12
11 15
366 463 590 502 301 419 66 204 301 419 419 578 67 225 419
590 471 336 545 546 67 578 230 133 161 578 67 225 448 449
419 172 578 67 225 419 67 236 516 139 225 419 544 480 481
911 912 910 911 912 813 109 170 484 199 225 161 576 67 578
864 865 866 420 201 911 912 109 521 586 419 911 912 813 110
896 897 898 518 552 40 419 66 425 225 578 67 35 911 912
518 587 520 580 518 555 428 420 522 419 67 743 744 747 455
586 192 161 72 585 586 161 192 585 457 457 775 776 779 487
16 161 727 663 664 9 225 225 578 521 518 518 516 548 272
726 661 858 859 860 660 161 192 132 516 864 865 936 806 807
826 827 826 826 827 628 161 553 516 518 896 897 968 32 839
