0e007210
19 21
475 475 475 475 403 410 506 475 475 475 475 475 539 538 475 475 475 475 475 475 475
475 475 475 539 222 441 475 475 475 475 475 539 403 410 538 475 475 475 475 475 475
475 475 539 251 252 253 254 475 475 475 572 506 222 441 507 538 475 475 475 539 538
475 539 282 283 284 285 286 287 539 572 539 251 252 253 254 538 538 475 539 403 410
475 507 314 353 414 358 318 319 506 538 282 283 284 285 286 287 507 506 539 222 441
475 539 281 385 317 317 360 280 506 539 314 353 414 358 318 319 507 506 251 252 253
475 475 313 445 317 317 382 248 506 475 249 385 358 388 386 280 507 282 283 284 285
475 475 313 445 317 355 414 390 359 359 391 445 317 317 317 312 539 314 360 350 358
475 539 281 445 317 387 413 390 359 359 391 445 317 355 414 312 507 346 446 317 317
475 507 281 445 317 355 414 312 475 475 281 445 317 387 413 312 474 378 445 317 355
475 539 281 445 317 387 413 248 474 475 249 445 317 355 414 390 359 391 445 317 387
475 507 249 445 358 358 317 390 359 359 391 445 317 387 413 312 474 281 445 317 355
475 539 249 360 412 358 386 248 474 475 249 445 358 358 317 312 474 249 445 317 387
475 507 473 339 344 343 339 473 474 539 249 360 412 388 360 248 475 281 445 317 317
475 506 372 373 374 375 376 377 507 507 307 244 245 276 277 339 474 249 360 412 317
475 475 404 405 406 407 408 409 475 538 372 373 471 472 376 377 507 307 244 344 343
475 475 507 437 438 439 440 506 475 539 404 405 406 407 408 409 507 372 373 374 375
475 475 475 507 602 602 506 475 475 475 507 437 438 439 440 506 475 404 405 406 407
475 475 475 475 474 474 506 475 475 475 475 507 602 602 506 475 475 507 437 438 439
