2e002f30
31 20
851 99 99 820 431 587 625 512 460 615 619 512 582 905 906 907 908 909 553 491
497 851 99 99 679 463 609 588 545 720 587 625 544 937 938 939 940 941 586 524
544 497 851 99 820 431 657 524 456 492 583 619 422 969 970 971 972 973 615 523
423 460 497 858 99 820 711 495 587 544 553 587 616 593 753 786 743 591 555 416
426 428 496 987 99 780 780 559 523 422 460 583 577 833 730 833 720 524 625 422
616 428 496 987 99 780 99 591 417 618 492 615 609 865 971 865 553 523 416 618
460 492 496 987 99 99 852 495 425 460 592 870 870 730 731 591 532 555 454 429
428 492 496 851 99 99 591 523 616 496 870 730 723 731 690 525 587 556 556 544
492 551 577 497 851 99 559 523 577 560 724 723 726 870 591 524 524 587 625 546
461 614 715 623 593 858 780 495 609 833 730 723 833 720 525 524 523 555 416 584
460 496 685 558 819 198 199 559 589 865 971 971 865 627 614 523 555 556 616 582
544 586 387 819 198 433 433 199 744 745 270 433 199 780 559 451 587 556 512 553
646 592 819 268 433 433 433 433 199 198 435 401 271 685 679 590 559 587 556 578
528 819 236 433 433 433 307 294 433 433 433 433 434 199 99 820 591 524 619 556
592 858 866 961 961 961 867 99 230 403 433 433 401 231 99 99 559 525 587 588
819 99 898 932 730 932 899 780 934 999 971 971 999 1000 780 99 704 495 524 424
99 99 898 729 691 725 899 819 966 819 99 99 99 99 707 673 679 559 523 616
99 99 962 833 730 833 963 780 966 987 99 99 99 677 885 711 99 820 559 513
99 987 834 865 971 865 802 780 966 987 99 99 99 99 99 99 99 852 591 417
932 987 99 99 99 99 99 819 966 707 99 99 99 99 99 99 744 745 559 424
99 987 99 99 99 99 99 99 966 780 674 673 738 738 674 890 685 679 591 427
1003 999 971 999 999 1003 971 999 1000 743 851 99 99 99 99 99 99 820 495 456
544 561 851 99 99 99 99 99 591 513 497 851 99 99 99 99 99 852 559 523
454 460 529 851 852 742 851 99 559 587 577 497 851 99 99 99 99 820 591 417
556 576 460 529 591 577 497 851 820 431 587 544 561 851 99 99 99 852 559 589
556 556 617 492 583 587 544 497 851 820 495 423 429 593 99 99 99 820 387 679
587 556 576 460 429 683 618 592 819 99 559 746 592 819 99 99 198 199 820 819
583 587 556 576 460 492 429 497 851 99 820 685 711 99 268 262 433 433 209 99
460 583 619 556 578 544 460 461 497 851 99 99 99 208 433 433 433 433 199 99
544 553 587 556 556 454 428 492 429 497 851 99 99 206 230 433 433 433 433 145
422 460 583 587 556 556 617 428 492 429 497 851 198 271 99 270 433 433 433 433
