33003435
28 30
213 213 213 213 213 213 213 213 213 213 213 213 213 213 54 559 580 514 546 512 583 456 429 429 592 102 6 4 39 102
213 213 213 213 213 213 213 213 213 277 277 26 25 213 22 102 559 587 556 556 544 583 617 592 132 9 4 36 7 134
277 244 213 213 213 213 213 277 212 87 26 43 103 125 56 135 685 559 587 556 616 613 545 497 66 103 38 39 38 7
244 213 213 213 213 213 245 277 20 102 6 4 7 96 97 9 7 685 559 587 578 544 618 429 593 162 103 67 6 4
213 213 277 213 213 213 277 22 674 9 4 720 39 25 124 134 38 10 7 559 587 423 429 592 6 7 66 6 4 36
213 245 244 245 276 213 26 67 206 395 38 39 101 55 213 56 9 782 41 67 559 622 592 67 40 39 769 38 42 39
213 213 213 213 277 20 67 274 401 231 674 677 674 23 276 213 54 38 36 7 103 67 67 6 4 7 103 674 677 102
276 213 213 277 22 102 208 401 176 102 742 742 742 103 27 213 213 56 38 4 43 103 6 720 36 39 130 101 67 57
23 276 213 26 102 130 742 230 231 591 579 578 545 497 103 125 213 124 134 40 5 10 783 4 39 130 163 135 55 212
103 27 124 102 130 591 545 497 591 525 587 556 616 429 497 21 276 213 52 38 39 38 815 41 130 135 116 53 244 244
199 103 126 134 163 495 616 496 559 715 524 587 513 615 545 593 21 213 245 56 134 132 38 39 135 57 212 244 244 213
231 66 3 66 591 555 544 429 497 103 559 715 715 417 618 497 55 276 213 245 56 130 103 102 135 125 244 213 213 213
209 101 27 54 559 587 546 512 465 130 69 686 655 616 429 496 25 244 213 213 124 134 98 101 55 244 213 213 213 213
6 7 55 245 58 559 587 556 512 497 742 621 618 716 494 592 103 23 213 213 213 54 164 57 244 213 213 213 213 213
4 39 23 213 245 56 559 587 588 578 616 581 545 497 684 685 134 103 21 213 213 213 128 244 213 213 213 213 213 213
41 101 57 213 213 245 54 559 715 619 578 544 618 429 593 103 102 135 103 27 213 213 160 26 21 87 276 213 213 213
39 101 125 213 213 277 26 742 591 417 584 423 429 496 135 6 7 6 8 103 27 22 132 103 132 67 125 213 213 213
206 66 27 213 277 124 591 545 646 618 582 622 494 592 9 4 720 39 206 274 199 262 209 836 135 55 244 213 277 276
144 199 103 125 213 22 495 522 429 615 545 593 685 135 6 36 39 66 230 231 230 231 130 328 346 282 213 277 216 217
270 231 103 27 212 56 559 622 592 559 558 137 135 67 40 782 8 807 808 809 104 640 68 264 401 314 277 216 932 199
230 199 43 103 125 213 54 116 53 54 685 101 102 103 38 4 7 839 840 841 136 676 507 401 247 244 245 248 230 231
7 238 720 7 21 213 213 245 244 245 56 67 134 164 103 38 39 871 872 873 66 136 306 247 244 213 213 245 379 344
41 66 38 39 66 27 276 213 213 213 245 54 57 128 52 117 118 134 230 390 198 199 198 215 276 213 213 213 245 212
39 938 939 940 760 103 23 276 213 88 213 213 87 160 213 213 245 54 119 507 247 246 401 247 214 215 216 217 276 213
822 970 971 972 726 760 66 21 26 132 27 22 102 132 27 87 213 213 245 347 244 245 281 212 246 401 932 234 217 276
726 1002 1003 1004 724 792 821 206 268 274 199 103 130 822 134 103 23 20 23 213 213 213 213 245 280 247 313 248 249 212
791 764 731 727 792 6 7 230 726 724 788 821 820 792 6 10 720 102 103 21 276 213 213 213 245 244 213 245 244 213
10 7 791 792 6 720 36 7 230 231 135 6 10 10 784 785 4 7 6 7 27 276 213 213 213 213 213 213 213 213
