33003435
32 32
512 583 456 429 429 592 559 587 556 512 429 583 417 618 429 494 592 134 98 135 55 212 212 212 212 88 84 85 86 24 591 616
556 544 583 617 592 132 103 559 587 588 578 617 581 545 429 497 67 102 135 103 27 212 212 87 26 102 98 98 135 591 555 544
556 616 613 545 497 134 98 103 559 715 619 578 544 618 429 592 102 98 759 760 103 27 26 102 98 135 771 644 643 559 587 454
587 578 544 618 429 593 932 135 742 591 417 584 423 429 496 135 134 98 230 726 760 103 102 98 135 644 130 6 7 645 559 587
559 587 423 429 592 6 7 591 545 646 618 582 622 494 592 9 7 134 103 791 932 164 6 7 134 674 105 38 4 7 643 559
67 559 622 592 67 40 39 495 522 429 615 545 593 932 135 6 5 7 134 98 789 6 4 4 7 162 102 932 38 4 7 704
131 103 67 102 135 102 103 559 622 592 559 558 137 131 101 38 4 5 7 134 854 38 42 4 4 10 7 6 10 42 39 704
163 135 135 6 7 134 135 67 134 134 135 134 98 98 135 6 4 5 39 102 98 98 103 38 39 38 39 38 39 741 673 102
135 135 6 720 5 67 67 6 7 6 7 932 134 135 6 39 38 39 102 135 134 932 760 98 103 676 673 674 677 102 135 631
135 6 4 5 39 67 6 4 5 720 5 7 6 7 4 7 100 820 760 103 102 198 790 759 199 98 103 102 135 631 570 598
6 816 817 39 67 6 4 5 932 4 5 39 38 5 4 782 7 932 725 145 756 788 176 230 792 134 98 135 631 598 135 6
38 848 849 7 67 38 39 38 4 5 39 102 103 38 4 5 39 134 791 726 231 822 758 760 208 469 104 772 564 677 674 38
103 38 4 5 7 98 98 103 38 39 102 98 135 67 38 39 6 7 98 854 98 789 791 724 145 436 473 209 600 98 103 676
134 103 11 38 39 98 206 135 198 760 134 135 6 7 67 67 38 39 102 98 759 788 821 932 725 231 360 164 599 570 630 6
7 134 98 98 103 135 758 932 725 231 136 6 4 4 7 67 67 102 98 759 790 98 759 724 726 760 101 6 7 134 600 38
720 7 134 98 98 103 230 726 790 164 101 38 4 4 39 67 102 822 759 726 792 820 724 724 724 724 821 38 783 7 600 6
4 39 6 7 134 98 103 144 790 102 101 6 4 39 67 759 756 790 230 792 6 7 791 724 724 176 135 6 815 39 600 38
39 395 38 39 6 7 162 791 790 162 103 38 39 67 820 726 788 724 760 6 4 39 98 758 724 792 103 38 39 631 598 135
100 230 145 932 38 5 7 162 791 760 134 206 131 822 66 854 98 758 792 38 39 759 756 932 792 135 631 34 571 598 135 6
7 103 238 395 6 782 5 7 198 724 932 725 209 791 757 760 98 789 98 759 756 726 790 98 101 631 598 822 98 135 6 880
39 135 198 231 38 4 720 39 230 724 724 792 6 7 134 791 756 726 760 854 932 725 790 98 135 600 134 758 760 6 720 912
677 674 230 199 103 38 39 134 98 230 790 101 40 4 7 134 932 725 724 756 788 724 792 101 631 598 102 726 932 4 5 944
7 103 105 270 209 104 677 674 105 98 144 760 38 4 41 134 98 791 726 231 98 791 757 821 3 101 820 788 792 38 782 5
783 8 392 359 135 677 137 103 100 198 177 792 103 38 39 102 206 198 724 145 760 98 822 101 599 570 571 630 98 103 38 720
41 102 333 6 7 6 7 67 102 230 205 676 105 104 102 198 401 401 401 724 724 760 791 760 103 135 134 599 571 630 103 38
4 932 231 38 782 5 39 101 134 98 326 136 674 677 102 270 247 246 401 177 231 758 199 791 760 6 7 98 103 599 630 103
38 39 132 9 720 5 7 67 102 206 198 199 132 103 134 270 282 20 238 135 134 791 792 43 932 720 39 102 135 631 598 135
206 198 199 135 38 720 5 8 198 177 307 294 199 135 102 230 314 52 118 57 54 105 6 784 785 39 102 677 674 564 677 674
337 247 246 473 508 38 39 102 230 199 103 134 331 6 7 208 215 212 212 212 214 469 38 42 39 741 673 100 631 598 102 103
313 214 215 246 436 469 164 198 199 331 135 43 135 932 39 134 270 314 212 214 177 231 103 676 470 199 103 102 600 98 98 135
312 401 247 312 401 436 473 401 401 209 135 38 7 6 7 102 270 282 212 246 199 98 98 198 247 246 199 206 564 206 198 199
212 313 212 212 246 247 246 401 401 199 508 6 782 720 39 198 247 212 212 212 246 199 198 247 212 212 313 313 606 246 401 401
