8e008f90
18 17
19 19 135 165 69 69 69 69 69 69 69 69 69 69 138 19 19
19 135 136 197 101 101 101 101 101 101 101 101 101 101 137 138 19
19 167 168 49 81 81 81 81 81 81 81 81 81 81 169 170 19
19 199 200 113 17 17 17 17 17 17 17 17 17 17 201 202 19
19 231 232 113 17 17 17 17 17 17 17 17 17 17 233 234 19
19 263 264 113 17 17 17 17 17 17 17 17 17 17 265 266 19
19 135 136 113 17 17 17 17 17 17 17 17 17 17 137 138 19
19 167 168 113 17 17 17 17 17 17 17 17 17 17 169 170 19
19 199 200 113 17 17 17 17 17 17 17 17 17 17 201 202 19
19 231 232 113 17 17 17 17 17 17 17 17 17 17 233 234 19
19 263 264 113 17 17 17 17 17 17 17 17 17 17 265 266 19
19 295 160 69 161 162 113 17 17 17 17 164 165 69 166 298 19
19 19 192 101 193 71 113 17 17 17 17 73 197 101 198 19 19
19 19 231 224 225 103 74 75 75 75 76 105 229 230 234 19 19
19 19 263 256 257 258 74 75 75 75 76 260 261 262 266 19 19
19 19 295 352 353 322 74 75 75 75 76 260 357 358 298 19 19
19 19 19 448 449 37 49 81 81 81 81 37 453 454 19 19 19
37 37 37 37 37 37 113 17 17 17 17 37 37 37 37 37 37
