6c00a36e
22 19
780 900 774 774 774 774 774 905 367 368 369 905 779 774 774 774 774 901 781
812 807 870 871 871 905 870 937 399 400 401 937 870 905 870 871 871 807 813
940 807 974 911 911 937 905 970 271 1 946 970 905 937 974 911 911 807 941
940 807 943 1006 1007 970 937 882 303 304 978 888 937 970 943 1007 1006 807 909
940 807 943 1006 1007 914 970 964 965 965 965 966 970 882 945 1006 1007 807 941
940 807 943 905 943 1007 914 200 201 202 201 204 914 945 1007 905 943 807 909
940 776 901 937 943 1007 1007 232 233 234 233 236 1006 1007 1006 937 900 777 941
972 844 807 970 943 1007 1006 264 265 201 267 268 1007 1007 1006 970 807 845 973
1004 876 807 882 945 1006 1007 296 297 298 299 300 1006 1006 1006 914 807 877 1005
911 908 807 943 1007 1007 1006 328 298 330 298 332 1006 1006 1006 1007 807 941 436
502 940 807 943 1007 1006 1007 297 298 338 363 299 1006 1007 1007 1007 807 941 468
501 940 807 943 905 943 1007 1007 241 242 243 1006 1007 1007 905 943 807 909 468
503 940 776 901 937 943 1007 1007 305 306 307 1007 1006 1007 937 900 777 941 468
536 972 844 807 970 943 1007 1007 305 306 307 1006 1006 1007 970 807 845 973 500
905 1004 876 807 882 945 1007 1007 298 338 339 1006 1006 1007 914 807 877 1005 905
937 436 908 807 943 1007 1007 1007 241 242 243 1006 1006 1006 1007 807 909 468 937
970 500 908 807 943 1007 1007 1006 305 306 307 1006 1007 1006 1007 807 909 500 970
914 408 908 807 943 1007 1007 1007 305 306 307 1007 1006 1007 1007 807 941 468 914
537 469 940 776 774 905 905 943 298 338 339 1007 905 905 779 777 941 500 502
504 503 972 313 313 937 937 943 273 274 275 1007 937 937 312 313 973 468 501
1006 537 1004 345 345 970 970 964 965 965 965 966 970 970 344 345 1005 500 504
470 1007 537 504 503 914 914 996 997 997 997 998 914 914 504 503 505 536 1007
