6c00a36e
28 21
964 965 965 966 806 870 871 871 871 871 871 871 871 871 804 772 837 870 871 871 804
964 965 965 966 806 974 911 911 911 911 911 911 911 911 804 772 837 974 911 906 804
964 965 965 966 900 810 777 943 774 774 808 809 875 943 776 774 777 943 1 943 804
911 911 911 911 838 870 373 943 372 871 871 806 373 943 870 871 373 943 911 1007 804
1007 1006 1006 1007 404 974 911 1007 911 911 911 806 974 1007 911 911 911 1007 1006 1006 804
1007 1006 1007 1007 911 1007 1007 1007 1007 900 810 905 779 774 774 774 725 837 943 1007 804
1007 1006 1007 1007 804 772 726 810 774 777 870 937 870 871 871 871 776 808 841 943 804
1007 1006 1007 1007 804 772 837 870 871 373 974 914 881 911 911 911 372 871 806 943 804
1007 1006 1007 1007 804 772 837 974 911 911 1007 1006 1006 1006 1006 1007 911 911 806 943 804
774 777 943 808 774 774 774 777 943 804 772 772 805 942 808 809 875 943 905 943 804
871 373 943 871 871 871 871 373 943 804 772 772 805 942 871 806 373 943 937 943 804
911 911 1007 911 911 911 911 911 1007 804 772 772 837 942 911 806 974 1006 914 945 804
1007 1007 1007 1007 842 808 809 810 774 774 808 809 777 943 1006 806 943 1006 1006 1006 804
774 777 943 774 905 870 838 870 871 871 871 838 373 943 1006 806 943 1007 1006 1006 804
871 373 943 871 937 974 405 974 911 911 911 405 974 1007 1006 806 906 1007 1006 1007 804
911 911 1007 911 914 945 911 1007 1006 1006 1007 911 1007 1007 1007 842 875 943 804 772 772
772 726 810 808 809 810 774 777 943 804 772 726 810 905 942 838 373 943 804 772 772
772 805 870 871 838 870 871 373 943 804 772 805 870 937 943 405 974 1007 804 772 772
772 805 974 911 405 974 911 911 1007 804 772 805 974 914 945 911 1006 1007 804 772 772
772 805 943 1007 911 1007 1007 1006 1007 804 772 805 943 1007 1006 1007 1006 1007 804 772 772
772 805 943 900 810 774 777 943 774 725 772 805 943 774 774 725 772 772 772 772 772
772 837 943 806 870 871 373 943 871 776 774 777 943 871 871 804 772 726 810 774 774
774 905 943 806 974 911 911 1007 911 372 871 373 942 911 911 804 772 805 870 871 871
871 937 943 804 772 805 943 1006 1007 911 911 911 1007 1006 1007 804 772 837 974 911 911
911 914 945 836 772 726 810 774 774 777 943 774 774 774 774 774 774 777 943 1007 1007
1007 1007 1007 776 774 777 870 871 871 373 943 871 871 871 871 871 871 373 943 1007 1007
1007 1 943 372 871 373 974 911 911 911 1007 911 911 911 911 911 911 911 1007 1007 1007
906 911 1007 911 911 911 1007 1007 1006 1007 1006 1006 1007 1007 1007 804 772 805 964 965 966
