6c00a36e
18 23
905 964 965 965 966 905 943 444 6 6 6 135 98 172 104 442 6 6 6 6 6 6 1007
937 974 911 911 911 937 943 168 905 166 442 6 443 1007 66 104 6 475 506 1006 166 443 6
888 1006 64 1007 1006 888 1007 98 937 943 905 779 774 343 774 774 774 774 774 901 948 104 6
65 443 1006 1007 64 1006 65 475 1002 945 937 246 279 871 278 310 871 871 871 905 980 174 6
1006 1006 65 1007 1007 474 1006 939 943 1006 1002 64 911 911 64 65 911 911 911 937 1012 66 443
806 943 410 1006 1007 1006 64 971 884 64 98 66 98 70 79 135 141 65 507 1002 70 79 135
776 774 774 774 853 943 1006 1006 98 66 1007 1007 136 38 38 939 943 98 64 905 102 6 6
278 279 871 310 342 943 1006 939 943 804 773 943 102 111 410 971 975 98 1006 937 884 102 6
65 911 911 64 65 507 65 971 975 836 773 943 98 1006 65 444 64 98 1006 888 66 98 168
135 78 98 66 66 98 66 65 1006 776 774 943 1006 1006 98 64 98 1006 1007 806 943 66 475
6 6 71 443 842 777 943 1007 65 870 871 943 1006 905 943 98 66 905 779 774 853 943 1006
102 111 103 98 905 405 943 939 98 911 911 1007 1006 937 943 1006 1006 937 870 311 373 943 65
98 507 98 1006 937 974 1007 971 884 65 1006 1007 1006 888 1006 65 506 888 911 911 911 1007 1007
774 777 948 65 1002 64 64 65 1006 838 943 65 1007 1007 1006 410 443 1007 1006 442 506 774 774
871 373 1012 74 134 79 71 1006 1006 405 943 1007 64 905 943 1007 776 777 943 6 443 871 871
911 911 98 102 111 900 777 943 64 911 1007 1007 1007 937 943 1006 870 373 943 1007 1007 911 566
79 79 135 98 66 806 405 943 1006 806 943 65 443 888 1006 1006 911 911 1006 1006 1007 1007 567
102 38 38 135 474 806 974 1007 1006 806 943 1007 1007 1006 65 1007 507 506 1006 806 943 1007 567
