3c00ce3e
18 22
38 38 38 73 99 99 99 99 99 459 720 753 721 753 721 721 753 459 1 99 99 194
38 38 224 38 79 71 194 99 99 459 720 753 753 721 753 721 721 459 2 195 99 99
38 38 38 224 224 38 71 99 99 552 485 720 753 485 490 720 753 490 433 460 521 147
38 111 167 166 6 167 166 79 71 471 474 452 453 474 459 452 453 621 723 722 459 630
103 194 99 195 110 224 99 102 103 621 506 452 453 506 459 723 722 722 753 753 459 662
99 99 99 99 99 224 99 224 260 273 728 665 756 275 459 720 753 97 752 721 459 662
194 463 460 460 460 460 521 761 724 730 194 729 724 730 459 720 721 754 753 753 490 662
99 459 723 722 722 722 552 521 630 724 728 697 697 307 459 720 719 752 719 752 421 662
99 459 720 97 752 721 421 552 521 629 463 460 460 460 521 752 781 755 781 755 486 662
195 459 752 754 753 721 486 421 552 553 459 723 722 722 459 720 721 721 721 721 459 662
195 459 720 753 721 753 486 486 421 621 464 720 721 721 552 460 460 462 752 753 459 662
99 552 460 485 416 485 428 486 486 723 722 721 97 752 722 722 722 754 753 721 459 662
275 535 535 473 451 473 534 430 486 720 753 753 754 721 721 721 721 753 721 753 459 662
730 439 439 475 451 475 440 439 430 720 753 721 721 721 463 460 484 417 418 484 464 661
307 535 535 506 451 506 534 535 535 430 460 484 720 484 464 555 506 452 453 506 555 694
11 554 554 506 451 506 555 554 554 554 554 506 451 506 555 34 761 756 728 665 728 307
194 103 208 665 724 756 273 199 395 198 209 208 305 209 99 99 360 301 194 331 194 99
99 99 194 296 724 305 231 359 304 301 99 11 195 224 99 99 195 99 99 99 99 11
