3c003d3e
27 25
463 426 426 426 426 426 426 426 426 426 426 426 426 426 426 426 426 426 426 460 431 576 576 576 521
491 823 824 825 824 825 824 824 825 824 825 825 825 825 825 825 824 825 825 825 450 608 609 610 459
491 820 463 426 426 426 426 426 426 426 426 426 426 426 426 426 484 417 418 484 521 608 609 610 459
491 820 491 518 517 456 584 426 427 426 426 427 585 457 518 517 516 452 453 516 459 608 609 610 491
459 820 491 2 36 456 586 523 484 592 484 523 583 457 2 32 685 854 825 685 459 608 609 610 491
491 820 459 2 456 584 429 527 516 623 516 527 428 585 457 96 749 820 822 749 459 608 641 610 491
459 820 491 2 488 457 523 499 595 595 595 469 522 488 457 128 821 821 821 821 459 608 641 642 491
491 820 491 2 456 489 528 658 625 625 625 659 657 456 489 128 719 820 822 719 459 672 672 672 491
491 820 491 2 488 489 560 627 690 625 691 627 689 488 489 128 814 852 821 814 525 513 416 385 493
491 820 491 2 484 430 426 484 560 627 689 484 430 426 484 128 717 853 821 717 459 823 824 825 491
484 820 459 64 516 555 554 516 820 821 822 516 555 554 516 160 749 820 821 749 459 820 822 821 491
551 820 491 823 824 824 825 824 822 821 821 825 824 825 824 824 821 822 821 821 525 741 742 743 521
486 822 552 426 426 426 426 426 426 426 426 426 426 426 426 426 426 426 426 426 521 608 609 610 491
486 822 824 825 824 825 824 824 825 824 825 825 825 825 825 825 824 825 825 825 524 608 609 610 491
431 576 576 576 576 484 430 426 426 484 416 484 430 426 426 484 711 576 576 576 521 608 641 610 459
491 608 609 609 610 551 554 554 554 516 420 516 555 554 554 519 608 609 609 610 459 640 641 642 491
491 608 609 641 610 486 824 825 824 825 825 825 825 825 825 422 640 609 641 610 491 672 672 672 459
491 640 641 641 642 463 426 426 426 426 426 426 426 426 426 521 640 641 641 642 525 513 416 385 553
459 672 672 672 672 459 823 419 824 825 824 825 824 824 824 459 672 672 672 672 491 518 420 518 517
552 484 416 484 433 431 576 576 576 576 576 576 775 431 426 426 484 416 484 430 553 2 370 273 273
554 516 420 516 555 491 640 609 609 641 609 641 642 459 518 517 516 420 516 518 517 34 338 337 337
825 824 825 825 825 484 640 609 609 641 609 641 642 491 2 198 337 337 273 275 269 198 337 337 231
821 821 821 821 822 519 640 609 609 641 609 641 642 459 2 338 337 337 337 337 337 337 337 339 100
821 821 821 821 822 422 672 672 672 672 672 672 672 491 2 296 337 337 337 337 337 337 337 337 275
426 426 426 426 426 426 426 426 484 416 484 430 426 553 2 302 337 337 337 337 337 337 337 337 337
517 517 517 517 517 517 517 517 516 420 516 518 517 517 34 302 337 337 337 337 337 337 337 337 337
199 102 103 268 274 273 273 273 273 337 273 273 273 275 272 200 337 337 337 337 337 337 337 337 337
