3c00683e
21 25
6 38 73 141 163 463 426 460 431 460 431 426 426 521 820 821 463 426 460 431 460 431 426 460 493
102 38 6 38 71 459 823 65 459 823 459 823 825 490 820 822 459 823 65 459 823 459 823 65 459
70 6 6 105 173 459 820 825 459 820 459 820 821 825 821 821 459 820 825 459 820 459 820 825 459
38 38 38 175 163 463 460 820 553 820 552 460 820 553 820 822 552 820 460 553 820 552 820 460 553
102 38 6 137 163 459 820 821 824 821 825 825 822 824 821 821 824 821 825 824 821 824 821 824 825
100 142 38 103 163 456 425 425 425 425 425 425 424 425 424 425 820 822 821 456 650 426 426 426 651
70 6 103 550 484 552 426 426 651 650 426 426 426 426 427 426 452 454 453 525 553 484 592 484 552
6 143 163 582 519 522 554 522 488 489 555 522 554 522 554 522 823 824 825 459 555 549 623 549 555
38 103 202 423 422 664 756 762 456 457 823 824 825 824 824 825 821 822 821 459 723 722 754 754 419
103 163 302 422 422 724 724 790 456 457 820 459 820 822 459 820 459 820 821 459 752 721 753 753 721
77 98 236 615 484 724 726 730 456 457 820 459 820 821 459 820 459 820 821 552 588 720 721 428 426
109 70 618 426 429 631 719 629 456 457 820 459 820 821 459 820 459 820 821 522 459 720 753 522 554
163 142 458 663 756 724 812 667 456 457 820 459 820 821 459 820 459 820 821 554 459 720 753 722 754
130 142 460 431 588 662 724 726 456 457 820 459 820 821 459 820 459 820 821 825 552 426 484 720 484
162 168 522 458 634 726 724 730 456 457 820 459 820 822 459 820 459 820 822 821 522 554 522 451 522
99 108 554 458 662 724 719 629 488 489 820 459 820 822 459 820 459 820 822 821 824 825 825 824 824
131 130 172 458 662 724 780 667 552 618 460 493 820 821 525 460 493 820 821 821 822 821 821 822 822
71 618 426 429 694 726 724 730 522 490 555 484 820 821 484 555 552 460 521 820 822 821 821 822 822
38 458 663 756 726 724 484 630 664 522 700 522 820 821 522 700 522 554 552 460 460 460 460 460 460
6 460 431 588 632 726 458 662 724 664 724 756 756 756 756 726 664 762 522 554 522 554 522 554 522
38 522 458 419 758 726 458 662 724 724 724 726 724 726 724 724 726 724 664 756 665 731 756 664 756
