01003803
16 25
619 545 497 782 66 720 782 66 743 591 424 682 745 66 66 591 419 618 592 66 66 66 66 66 70
417 618 592 66 932 66 66 352 549 417 618 593 679 66 626 417 618 560 196 66 66 66 66 932 6
426 592 720 932 66 66 752 481 582 424 592 66 782 66 782 748 560 66 228 800 197 782 134 6 6
558 66 66 66 66 384 456 618 779 558 66 66 70 15 43 45 66 66 720 498 66 112 6 932 6
66 782 78 66 66 559 587 780 775 777 66 932 6 932 775 776 777 66 66 782 66 66 166 111 111
782 70 6 71 66 782 751 66 66 66 782 66 172 66 626 714 650 745 66 66 228 768 706 66 66
79 6 6 6 79 135 720 66 66 66 66 44 79 71 493 690 745 66 66 782 66 66 228 771 738
6 6 6 6 6 6 45 66 782 66 720 66 102 6 75 751 932 66 66 782 70 71 498 768 706
6 6 6 169 110 102 45 720 782 66 66 782 66 136 73 78 75 66 66 66 168 38 77 66 228
110 110 110 743 776 777 70 79 135 78 70 79 43 111 114 6 932 66 66 70 6 6 146 273 199
66 782 352 386 718 66 172 166 6 6 6 167 66 749 750 166 6 71 782 168 6 6 178 433 401
743 752 417 481 496 720 66 782 172 110 110 107 626 424 649 745 102 6 71 720 102 167 107 933 433
481 583 456 581 545 497 66 66 782 742 711 66 752 616 592 66 70 6 6 79 45 720 198 433 401
455 553 587 562 618 592 66 66 591 426 649 745 559 780 776 777 102 111 111 103 66 208 433 933 433
555 617 583 424 560 720 66 66 430 616 592 202 207 269 782 932 66 66 782 66 66 782 144 433 401
587 617 779 589 66 66 782 626 747 560 202 200 433 434 273 273 199 66 66 66 268 262 433 933 433
