01000203
22 22
38 169 166 38 38 38 71 168 38 38 167 104 137 98 98 98 689 715 747 779 746 592
38 137 98 172 166 38 38 135 168 143 783 106 143 720 782 98 98 98 626 750 660 538
38 137 98 720 98 102 167 110 166 103 784 785 102 43 45 98 98 98 98 679 696 749
38 38 79 135 75 98 98 631 571 570 570 566 597 98 98 782 98 631 34 571 598 781
166 114 167 102 45 631 571 629 70 82 71 498 628 570 597 631 597 601 98 98 775 776
98 782 98 596 570 598 163 43 114 38 38 43 135 75 628 598 628 635 597 98 98 98
98 596 570 629 499 98 98 98 782 102 103 782 102 45 98 98 98 98 628 597 98 98
98 628 597 98 98 596 602 630 98 98 596 570 597 596 570 597 98 98 98 600 98 98
44 71 600 98 98 604 634 629 98 98 664 98 628 598 98 600 98 782 98 600 98 98
98 102 2 782 98 600 98 98 98 98 600 98 98 98 98 600 140 75 596 629 98 98
98 596 598 14 98 564 98 98 596 571 635 570 597 98 98 601 112 137 628 597 98 98
98 600 70 103 596 629 98 782 2 135 75 98 600 98 596 629 807 808 809 600 782 98
98 532 34 570 605 98 98 98 600 102 77 596 629 70 2 45 839 840 841 564 98 98
98 600 104 137 628 597 98 98 628 597 98 628 597 42 564 98 871 872 873 600 146 273
596 629 136 143 596 629 98 782 98 628 34 570 629 46 600 98 204 401 145 2 306 403
600 98 168 80 628 570 597 98 98 98 70 169 98 98 600 782 392 306 179 600 782 144
564 467 72 807 808 809 600 98 98 817 168 175 596 538 629 98 361 98 596 629 98 360
276 54 46 839 840 841 628 597 467 98 35 596 629 70 43 45 631 570 629 98 98 679
276 124 395 871 872 873 98 628 565 570 570 629 70 103 596 570 629 98 98 742 749 750
276 276 246 273 435 263 207 324 390 98 14 782 46 596 629 98 98 98 749 581 424 649
276 276 276 246 401 401 231 784 785 98 166 79 45 628 597 98 98 98 430 545 618 779
276 276 276 312 401 176 98 848 98 98 782 46 596 570 629 98 98 626 525 549 545 682
