01005b03
21 30
612 620 425 560 755 818 818 946 818 818 689 580 425 718 679 818 783 786 787 913 818 786 787 818 559 426 429 615 555 556
608 160 530 721 722 818 849 946 818 849 626 160 747 592 786 849 815 64 944 946 818 945 721 722 722 781 615 555 556 620
589 818 818 753 754 946 815 65 64 67 130 162 783 130 64 162 208 273 199 721 384 750 753 754 787 722 559 160 588 416
679 818 913 818 946 67 67 782 67 782 130 130 850 130 130 130 782 144 271 786 559 690 752 690 753 754 787 722 559 747
722 818 785 782 783 784 785 67 67 67 67 352 625 774 67 720 67 270 176 65 783 590 559 456 613 355 753 754 787 818
754 913 818 67 815 67 816 817 67 67 384 481 586 651 745 67 720 270 271 782 67 679 786 689 545 581 385 753 754 680
818 849 64 816 817 849 848 849 67 679 559 747 585 456 718 784 785 300 294 273 199 206 786 753 781 615 549 623 581 522
913 818 818 848 849 67 67 783 818 785 818 818 559 160 580 690 818 785 782 230 231 230 199 786 755 559 525 549 544 581
786 787 914 67 67 202 262 273 199 720 65 65 782 720 495 456 497 815 395 782 67 720 368 305 305 261 721 689 746 779
882 945 785 720 67 236 401 433 231 67 786 723 944 119 559 587 617 719 368 263 262 273 231 783 198 433 263 269 721 818
753 787 722 815 67 720 270 401 209 721 950 951 952 221 58 119 657 723 230 305 177 271 720 815 230 305 177 271 64 65
944 753 754 818 782 67 230 271 720 65 982 983 984 25 87 475 56 755 723 817 782 368 273 273 209 721 817 368 273 199
547 580 690 818 818 98 782 361 198 263 207 269 163 944 818 123 28 753 787 849 208 433 305 231 711 721 818 230 177 433
424 583 456 497 723 130 162 784 230 305 305 231 131 720 721 91 92 711 198 199 782 331 679 721 721 755 65 67 782 270
747 779 587 513 648 818 130 162 67 721 818 785 131 721 818 23 24 753 270 401 209 67 591 545 712 721 67 202 262 401
744 745 559 587 577 818 130 130 784 818 116 117 53 58 721 679 721 652 230 231 721 591 419 618 592 65 67 302 401 433
512 497 679 559 160 750 163 163 720 59 475 475 476 22 786 723 65 67 67 784 818 495 424 592 67 720 67 236 433 401
587 657 818 818 945 946 131 131 721 25 87 89 26 818 945 946 720 67 67 557 581 715 589 818 67 67 784 785 300 232
583 780 818 945 946 163 163 131 721 786 787 755 818 785 67 67 67 67 493 714 560 753 680 745 67 67 67 67 67 782
465 818 945 785 782 131 131 67 782 652 946 64 65 67 782 67 783 67 721 711 721 787 723 785 782 67 67 67 67 67
544 718 818 818 67 720 67 684 653 685 163 163 131 782 67 784 786 787 723 786 787 753 754 785 67 67 720 67 783 67
