01000203
20 29
723 720 164 164 720 783 784 753 785 164 164 782 136 6 175 782 848 849 78 165 591 524 555 554 556 512 429 550 422
721 882 720 164 784 723 785 720 162 162 720 70 6 38 73 78 783 70 81 493 524 525 587 588 620 556 544 551 424
787 914 723 208 273 263 269 164 164 163 164 102 38 6 6 6 82 6 103 711 495 523 524 524 587 588 459 586 456
945 946 946 785 230 305 177 199 163 164 164 164 102 38 38 38 103 110 782 165 495 481 583 523 524 525 491 615 620
816 723 720 66 98 164 164 238 208 275 267 132 720 102 6 103 132 783 165 782 559 456 779 524 523 555 416 550 619
848 849 675 229 162 163 164 684 162 300 325 203 132 164 113 135 132 132 783 260 261 689 750 689 525 587 423 428 550
720 677 229 162 162 162 720 170 685 66 302 265 132 162 102 103 720 132 815 292 293 721 685 626 525 453 424 428 551
673 229 74 78 134 77 162 162 652 653 236 305 337 261 164 165 132 782 162 784 785 654 775 679 689 485 456 585 555
164 720 174 6 6 109 163 164 162 170 685 132 132 361 132 132 162 162 720 162 680 776 744 745 721 463 555 452 417
849 162 136 38 103 162 784 785 162 782 131 684 132 132 98 99 162 162 162 679 775 721 652 653 654 495 588 484 522
849 70 6 6 135 782 162 163 782 162 720 132 132 132 130 131 720 162 744 745 163 815 652 880 882 559 524 523 425
162 102 38 38 38 71 720 162 783 782 131 132 868 163 132 132 162 162 162 711 76 82 71 721 652 653 559 524 459
720 70 6 6 6 6 71 162 815 163 720 132 132 132 132 782 162 162 162 162 174 38 103 684 720 202 203 559 491
162 102 6 6 38 38 143 782 162 132 163 782 163 395 132 132 162 784 162 162 131 46 162 684 782 234 235 752 555
816 817 168 38 6 6 6 71 162 132 782 720 162 292 263 203 162 162 162 749 712 745 721 721 652 653 684 495 587
723 849 106 104 38 38 38 143 164 130 130 131 131 206 359 299 162 784 785 495 496 66 170 684 653 654 591 524 609
755 162 783 106 111 38 6 6 71 163 807 808 809 144 205 162 162 685 132 748 560 98 164 685 654 493 524 555 610
753 882 815 720 782 102 111 111 103 162 839 840 841 270 265 162 684 162 162 133 720 164 685 684 685 679 495 619 620
912 721 722 882 164 720 164 164 164 164 871 872 873 296 271 98 99 164 133 720 720 685 652 752 385 777 463 619 556
944 753 754 753 881 721 882 720 164 164 164 230 275 200 231 130 131 720 783 720 652 720 721 689 690 655 524 587 588
