01000203
22 20
549 423 429 429 592 116 53 56 57 509 510 475 56 652 652 559 524 524 577 461
559 424 429 592 53 475 476 84 86 26 25 476 477 54 59 56 559 524 459 461
782 781 592 53 477 478 22 782 857 858 859 25 509 478 22 25 52 559 456 496
744 745 720 29 509 510 58 99 889 890 891 99 25 510 56 57 24 99 559 780
679 654 171 93 477 478 24 99 921 922 923 783 57 477 478 28 783 776 652 652
782 711 57 475 476 510 58 720 266 330 235 815 91 509 510 60 815 782 679 99
99 685 25 477 478 478 220 99 240 265 99 99 25 477 478 92 784 785 99 99
99 782 59 477 478 510 476 52 264 271 116 118 53 509 510 24 782 99 99 782
782 99 25 509 477 478 475 476 34 34 475 476 477 478 22 782 99 99 816 817
684 685 782 25 509 475 476 220 296 369 91 477 477 478 56 782 782 99 848 849
775 776 777 720 123 477 22 25 34 34 475 476 509 510 24 782 99 782 99 99
625 685 99 99 25 605 198 273 435 176 23 26 25 24 782 99 99 99 99 99
657 782 99 782 596 598 270 433 401 401 263 272 269 99 782 99 772 197 99 769
545 497 99 720 599 597 300 294 305 295 304 306 401 273 199 99 782 674 769 229
559 780 784 785 769 628 630 711 749 750 679 684 230 305 177 337 390 74 78 134
782 804 782 769 99 99 600 626 746 560 677 674 685 99 816 817 720 106 166 111
99 142 135 99 99 99 600 99 684 685 782 99 676 773 848 849 99 99 99 782
134 38 38 79 45 208 2 337 209 99 208 273 199 228 676 782 782 395 784 785
38 114 111 167 743 99 628 630 99 742 743 230 393 327 203 782 388 328 272 267
167 99 742 591 545 497 684 600 384 578 425 497 99 298 326 99 163 236 401 199
99 749 581 611 521 429 719 564 559 587 457 429 497 743 720 99 99 99 300 306
384 455 460 583 521 496 631 606 630 559 587 580 578 426 497 684 685 804 99 99
