01000203
10 15
99 99 782 748 593 596 635 629 752 485 620 657 591 426 581
631 34 603 539 570 598 711 591 386 583 587 512 614 424 492
634 34 598 99 626 750 591 523 562 429 583 587 419 618 585
742 774 44 79 71 679 689 525 424 429 553 417 618 429 550
459 718 742 102 103 626 750 689 747 494 585 491 429 492 560
616 615 426 529 99 99 743 774 163 99 559 587 545 464 593
551 419 618 496 679 384 517 690 777 720 679 689 747 592 626
614 456 429 613 385 550 523 616 529 774 817 162 163 815 388
582 523 580 555 576 551 555 545 429 649 745 208 273 199 720
429 583 525 587 588 514 451 424 461 460 529 99 230 434 199
