16001718
14 15
224 198 726 463 460 431 426 426 460 431 462 521 103 162 130
130 729 231 491 555 491 555 522 554 491 555 491 71 162 224
274 724 199 589 782 491 823 825 824 491 782 491 143 761 762
294 724 790 621 813 491 820 821 821 491 813 484 143 729 794
130 729 790 824 821 552 426 820 428 553 820 549 103 727 224
99 793 730 458 820 554 522 820 522 554 820 825 208 697 762
130 130 734 491 820 825 825 821 825 824 822 484 71 162 793
224 192 727 491 820 822 821 822 822 821 821 491 143 162 130
130 761 790 552 484 820 821 484 430 426 426 553 143 162 130
130 729 790 517 549 820 822 549 518 517 517 517 103 162 130
130 793 726 762 36 761 756 756 756 756 199 36 162 130 130
130 130 793 763 390 793 724 726 763 726 730 130 98 99 194
130 130 130 130 130 224 793 794 130 793 794 130 130 131 130
274 665 199 224 192 130 130 130 130 224 192 130 194 192 395
