1000b712
10 15
544 812 912 618 619 911 877 877 877 911 877 877 877 911 877
576 876 109 551 548 428 420 427 419 611 612 613 611 612 613
877 912 109 521 522 578 675 612 677 643 644 645 643 644 645
608 609 610 585 516 554 707 644 709 553 484 428 549 580 548
640 641 642 419 521 452 457 516 457 489 522 672 609 674 521
553 336 578 553 489 489 489 452 522 419 172 704 641 706 556
460 457 457 584 614 615 616 585 516 428 488 549 580 549 518
484 516 522 578 646 647 648 544 519 611 612 613 973 941 942
865 866 460 457 548 484 554 576 519 643 644 645 972 996 779
897 898 460 516 484 165 164 484 452 548 516 457 548 549 420
