10001112
10 15
304 45 303 207 554 908 486 522 100 419 553 484 586 164 472
302 740 741 742 460 420 516 522 419 303 516 740 741 742 518
293 772 773 774 455 876 335 518 457 302 302 772 773 774 877
419 138 484 548 582 844 877 813 422 452 336 419 521 518 548
591 599 601 484 302 420 427 876 454 302 139 142 518 239 516
302 472 740 741 742 814 877 846 877 877 878 66 172 419 335
271 302 772 773 774 460 518 876 454 552 419 458 611 612 613
234 240 239 484 548 302 452 908 486 484 876 421 643 644 645
69 68 69 265 234 228 302 548 516 452 875 454 457 548 466
78 110 77 329 160 132 516 165 164 586 907 454 484 531 398
