10002212
14 18
578 911 912 877 911 912 721 849 850 852 657 849 850 852 657 849 850 850
77 973 744 936 806 807 750 881 882 883 655 881 882 883 655 881 882 882
37 972 997 968 838 839 782 913 914 915 687 913 914 915 687 913 914 914
193 161 521 484 452 548 748 752 357 720 657 849 850 850 850 850 850 850
548 457 452 484 516 522 46 103 588 36 750 881 882 882 882 882 882 882
518 516 516 516 580 489 548 457 516 554 848 881 882 884 914 914 914 914
743 744 747 523 193 192 521 516 516 522 848 881 882 883 721 849 850 850
775 997 779 491 578 142 808 806 807 491 750 913 914 915 687 881 882 882
160 521 516 516 304 303 840 838 839 523 748 622 623 656 689 913 914 914
553 516 516 516 489 452 484 516 516 586 193 160 160 161 748 752 357 720
516 452 484 522 419 521 516 516 522 161 419 553 428 520 488 548 427 193
516 864 865 933 744 747 424 516 489 549 457 522 193 544 160 172 161 419
516 896 897 965 997 779 460 522 578 973 865 866 4 576 192 193 193 193
165 161 521 548 452 516 516 516 133 972 897 898 102 43 192 193 578 193
