10002212
14 18
578 911 912 877 911 912 721 622 622 656 689 817 819 819 721 622 622 622
77 973 744 936 806 807 750 785 820 786 655 785 820 786 655 785 64 785
37 972 776 968 32 839 782 817 818 819 687 817 819 818 687 817 786 818
193 161 521 484 452 548 748 752 817 720 689 817 818 819 748 752 817 720
548 457 452 484 516 522 46 103 588 36 654 817 818 819 786 787 819 787
518 516 516 516 580 489 548 457 516 554 786 819 818 818 818 818 818 818
743 744 747 523 193 192 521 516 516 522 819 818 64 817 721 622 622 622
775 776 779 491 578 142 808 806 807 491 655 817 786 818 687 785 820 786
160 521 516 516 304 303 840 32 839 523 748 622 623 656 689 817 818 819
553 516 516 516 489 452 484 516 516 586 193 160 160 161 748 752 817 720
516 452 484 522 419 521 516 516 522 161 419 553 428 520 488 548 427 193
516 864 865 933 744 747 424 516 489 549 457 522 193 544 160 172 161 419
516 896 897 965 776 779 460 522 578 973 865 866 4 576 192 193 193 193
165 161 521 548 452 516 516 516 133 972 897 898 102 43 192 193 578 193
