1000cb12
10 15
969 970 971 522 578 128 521 516 516 518 133 775 776 777 997
240 489 516 580 520 457 484 452 489 580 484 516 516 516 489
193 193 172 812 912 486 516 582 911 813 422 452 484 522 419
911 912 911 912 43 585 452 522 225 911 912 911 912 911 912
578 67 34 419 66 193 521 522 193 419 67 34 480 481 67
34 193 419 480 481 553 452 484 554 480 481 66 34 34 193
225 578 67 34 419 521 484 516 522 34 578 419 66 193 193
193 34 480 481 67 521 452 516 522 419 578 67 419 419 193
225 193 578 67 193 521 518 516 302 133 34 193 578 67 193
193 193 419 66 132 302 516 516 516 522 193 193 34 578 66
