01000203
10 15
99 976 942 977 736 99 99 99 23 477 475 476 56 197 23
99 973 974 975 676 99 99 99 783 21 509 510 573 54 57
99 1005 1006 1007 99 736 99 932 99 99 23 478 475 510 509
99 99 230 199 99 768 677 74 75 99 677 23 476 477 22
643 99 99 238 139 99 140 72 73 675 804 99 25 26 99
675 720 70 71 99 99 142 38 38 135 99 720 99 99 198
641 44 6 6 109 782 172 166 38 6 137 99 99 804 359
673 99 142 103 99 591 651 932 102 103 173 198 263 267 99
140 134 143 99 591 523 355 557 593 99 198 401 433 201 262
6 6 167 493 524 451 520 425 718 711 296 433 401 433 401
