01000203
15 15
130 130 130 903 904 905 903 904 905 130 431 747 779 746 613
130 817 720 935 936 937 935 936 937 626 750 903 904 905 751
720 720 817 967 968 969 967 968 969 527 718 935 936 937 679
130 848 720 198 401 337 337 307 749 618 560 967 968 969 130
130 130 208 401 231 817 130 720 781 560 817 130 328 267 130
130 130 817 238 70 71 130 352 718 815 932 720 234 326 130
720 130 130 44 6 80 493 424 496 130 130 848 70 71 130
816 817 130 817 142 900 431 424 429 719 720 70 111 167 784
749 750 816 130 102 6 71 748 592 130 112 167 784 785 782
746 592 626 750 130 166 167 817 130 130 743 384 386 497 783
903 904 905 527 529 817 932 130 130 384 424 583 513 492 497
935 936 937 559 545 593 14 130 749 581 456 553 587 544 585
967 968 969 130 751 70 167 752 457 492 833 481 550 459 613
146 401 263 269 44 167 384 609 587 617 615 424 553 747 494
401 401 401 297 130 493 424 618 833 549 555 425 528 776 777
