01000203
10 16
761 727 805 805 506 197 163 163 784 785 163 643 197 720 783 782
836 805 336 734 720 676 196 816 817 163 783 720 641 782 815 163
761 790 817 805 760 640 705 848 849 938 939 940 228 229 163 782
793 794 805 901 792 674 705 932 163 970 971 972 196 677 674 163
674 163 784 785 163 817 768 197 163 909 910 911 675 138 769 771
71 70 79 82 71 163 228 768 817 759 726 760 817 673 229 98
6 6 6 38 103 162 98 131 720 758 763 792 468 869 199 98
38 6 6 81 98 99 162 131 130 789 98 198 435 401 231 99
102 103 102 103 162 163 130 163 130 270 273 293 300 301 98 782
98 720 932 782 641 131 163 162 198 433 271 98 130 880 881 882
