01000203
10 15
724 176 626 715 424 560 748 716 494 779 715 587 556 450 523
726 433 199 720 751 647 816 817 854 855 856 495 587 610 524
305 307 294 209 162 782 848 849 886 887 888 559 715 612 416
761 762 162 162 162 761 756 205 918 919 920 720 654 689 747
931 932 793 762 208 726 724 237 729 762 720 208 727 932 711
652 749 712 745 162 230 726 731 726 293 162 68 899 720 706
580 425 429 561 782 162 238 300 301 162 162 162 163 675 785
555 616 492 496 384 625 686 685 162 162 162 162 163 162 162
450 513 429 460 581 579 457 497 749 750 784 785 162 162 162
484 619 579 512 551 587 451 545 581 578 425 718 720 162 162
