01000203
10 15
401 433 433 271 720 783 786 787 720 786 495 481 583 523 587
305 433 177 433 199 815 720 720 782 818 559 522 779 524 523
782 238 782 230 433 263 272 269 164 782 626 589 647 689 525
881 720 162 720 300 232 433 176 208 337 390 721 685 626 525
784 785 720 162 782 234 304 294 199 784 785 652 679 711 689
684 782 162 162 162 162 131 131 230 337 261 782 782 684 684
721 722 815 162 162 162 720 162 131 204 435 263 272 269 132
753 754 783 162 162 720 782 162 131 234 304 294 433 433 199
782 679 815 723 784 785 677 229 162 132 720 132 230 433 433
711 720 723 723 720 675 229 642 720 783 131 685 198 433 433
