7a007b7c
32 24
544 583 587 544 937 937 937 428 583 545 428 551 427 553 587 546 578 617 428 428 586 524 417 618
423 553 417 618 969 938 970 494 592 495 545 582 549 545 583 619 556 578 617 428 551 524 427 428
426 560 751 592 1001 14 1002 163 685 559 459 496 559 746 615 587 588 588 545 428 582 417 618 428
558 624 197 163 70 6 77 163 198 197 751 592 684 685 559 417 646 583 459 429 492 618 428 428
229 14 100 70 6 38 73 70 82 45 229 198 292 293 295 559 580 545 618 581 544 428 428 428
70 38 82 6 38 6 38 6 103 163 100 100 289 288 256 295 559 715 580 545 618 428 428 428
864 114 38 38 6 38 6 38 71 163 70 82 45 289 392 256 295 679 559 424 428 428 428 428
198 675 102 6 38 6 38 38 81 100 102 81 100 100 289 392 393 192 742 495 545 428 716 585
769 163 70 38 6 38 38 114 103 163 100 102 82 45 132 352 353 591 616 583 622 592 163 559
100 70 103 113 38 38 103 163 55 56 100 163 46 44 82 71 720 524 545 496 685 742 742 591
82 81 768 102 103 46 163 57 244 245 52 117 118 229 102 81 100 559 746 592 591 580 580 417
6 103 642 100 100 119 55 212 244 213 213 245 124 163 44 38 71 198 14 679 559 524 524 616
38 45 676 675 57 212 244 244 213 213 213 213 245 54 163 102 114 45 102 71 229 559 524 545
102 71 163 163 125 244 213 213 213 213 213 277 212 124 100 163 119 197 70 6 45 65 495 424
70 103 100 55 244 213 213 213 213 277 212 212 245 213 56 55 212 58 102 38 71 198 559 622
113 71 100 125 213 213 213 213 213 213 245 213 213 213 213 245 244 124 132 102 81 163 197 679
6 143 229 23 276 213 213 87 213 213 213 213 213 213 213 213 213 22 163 70 103 197 742 591
6 103 197 163 21 277 26 4 27 88 213 213 277 87 276 213 213 54 132 102 71 591 616 583
114 71 163 100 57 22 163 292 295 163 21 277 20 5 125 213 277 212 54 70 103 495 427 492
197 142 71 55 277 54 4 392 256 295 55 22 163 57 244 213 213 245 124 102 45 559 520 545
163 102 103 27 245 124 100 289 392 359 23 54 59 244 213 213 213 277 26 70 45 100 559 558
70 71 163 57 213 245 56 198 289 353 197 27 213 213 213 213 213 245 56 113 45 929 930 931
38 103 163 125 276 213 124 100 163 100 163 55 213 213 213 213 213 277 124 102 71 961 962 963
102 71 100 21 212 276 213 54 116 117 53 213 213 213 213 213 277 87 26 44 103 993 994 995
197 102 71 57 244 213 213 213 245 212 244 213 213 213 213 87 26 132 768 70 82 71 14 198
224 44 143 23 276 213 213 277 276 213 213 213 213 277 22 132 44 928 76 6 169 102 103 70
100 198 46 100 125 276 277 212 212 244 213 213 213 245 54 864 928 14 136 38 109 163 100 102
295 163 100 132 27 276 276 244 213 213 213 213 277 87 26 46 677 102 6 38 71 676 198 229
256 295 163 70 77 25 84 86 212 276 88 87 22 132 768 675 229 44 38 114 81 163 768 677
256 327 197 113 137 163 100 132 27 20 100 132 198 70 82 79 71 70 103 44 38 71 70 82
256 295 295 102 114 71 70 71 229 70 79 135 134 6 114 167 166 6 71 100 102 38 6 6
256 256 295 224 197 102 6 38 82 6 38 114 38 103 70 71 70 38 114 82 82 6 38 38
