0a00dc0c
10 15
683 644 643 768 644 643 442 443 444 644 643 768 644 643 683
503 676 675 800 676 675 474 475 476 676 675 800 676 675 503
503 814 781 516 814 781 719 507 719 814 781 516 814 781 503
503 469 467 535 541 468 538 539 538 541 468 535 541 468 503
535 541 468 435 468 468 468 435 468 468 468 435 467 467 535
468 683 469 467 468 435 468 467 468 435 468 467 468 683 469
436 503 469 435 435 467 435 435 435 467 435 435 468 503 469
563 503 564 565 502 467 467 467 467 468 499 500 501 503 563
781 503 814 148 534 435 467 467 467 435 531 148 777 503 814
181 537 181 180 566 452 454 454 454 453 566 180 181 537 181
