0a00520c
28 17
459 784 785 785 785 785 490 720 721 721 520 901 426 912 913 911 428
459 784 1 784 1 784 786 721 721 721 459 723 786 944 624 946 787
459 784 786 785 786 785 491 720 719 720 459 720 785 688 627 689 785
552 427 427 784 427 426 553 720 751 721 490 720 785 785 785 785 785
722 722 722 721 722 722 722 721 721 721 722 721 721 721 721 721 721
721 721 721 721 721 721 721 721 721 721 459 720 721 721 721 721 721
721 721 520 901 427 720 428 460 461 462 427 460 461 427 427 426 427
721 721 459 823 824 821 824 825 459 723 722 722 459 823 824 825 824
721 721 459 820 822 419 821 822 459 720 721 721 459 820 821 822 822
721 721 491 820 822 822 822 821 459 720 721 721 459 820 821 821 822
721 721 552 427 460 460 460 427 553 720 721 721 552 427 820 428 460
721 721 722 722 722 722 722 722 722 721 721 721 722 722 721 722 722
721 721 484 433 427 427 427 426 427 426 427 426 427 427 427 427 427
452 453 810 867 960 961 866 960 961 866 960 961 866 960 961 866 960
722 722 811 722 722 722 722 722 722 722 722 722 722 722 722 722 722
721 721 721 721 721 721 721 721 721 721 721 719 720 721 721 721 721
427 427 427 460 461 427 427 427 427 521 720 751 721 520 901 427 427
786 786 786 786 491 867 960 961 866 484 720 721 721 484 867 960 961
785 785 785 785 459 723 722 722 722 810 720 721 721 810 723 722 722
785 1 1 784 459 720 721 721 721 811 721 721 721 811 721 721 721
785 786 786 785 491 720 721 721 721 721 721 719 720 721 721 721 721
484 784 484 433 553 720 721 721 721 484 720 751 721 484 720 721 721
810 483 810 614 609 720 721 721 721 459 720 721 721 459 720 721 721
811 722 811 722 722 721 721 721 721 491 452 454 453 459 720 721 721
746 746 746 746 746 746 746 746 746 583 452 454 453 583 750 746 746
740 608 609 740 608 609 740 608 609 810 452 454 453 810 614 609 740
35 36 4 761 665 762 35 36 4 597 756 756 756 598 36 36 4
67 162 761 724 724 724 665 665 665 724 724 724 724 724 731 731 731
