0a00800c
20 21
522 746 747 684 685 746 747 684 685 746 747 684 685 746 747 684 685 746 747 746 747
586 631 757 199 490 631 263 269 490 873 843 844 490 874 843 844 458 820 761 756 756
554 662 419 337 757 724 337 792 844 842 842 842 844 842 841 842 458 820 419 178 179
586 662 788 307 458 630 794 842 458 877 841 842 458 877 842 842 458 820 821 822 821
525 427 427 460 461 427 820 492 461 427 427 460 461 427 427 460 461 429 820 716 461
586 823 824 825 490 823 822 825 490 823 824 825 490 823 824 825 490 823 822 825 459
554 820 146 147 825 821 822 821 825 821 822 821 825 821 822 821 825 821 822 821 459
586 146 337 792 458 820 821 822 458 820 821 822 458 820 821 822 458 820 821 822 525
525 429 629 492 461 746 746 684 461 427 427 460 461 427 427 460 461 747 820 716 493
586 631 724 762 458 873 843 843 490 823 146 760 490 823 824 825 458 823 822 825 459
554 662 337 794 458 876 419 842 843 822 729 726 728 760 419 822 458 820 822 821 459
586 662 179 822 458 876 841 842 458 820 791 307 458 630 147 821 458 820 821 821 491
525 427 820 492 461 746 746 684 461 427 820 492 461 427 427 460 461 427 820 716 493
586 823 822 825 458 874 843 844 490 823 821 825 458 823 824 825 490 823 822 825 459
554 820 822 821 458 877 842 842 824 822 1 820 458 820 822 821 824 822 822 821 459
586 820 821 822 458 877 841 842 458 820 825 821 458 820 821 821 458 820 821 821 491
525 427 820 492 461 747 877 716 461 427 427 460 461 429 820 492 461 746 746 684 493
586 823 822 825 458 873 842 843 490 823 825 825 490 823 822 825 490 873 843 843 459
554 820 1 820 458 877 842 842 821 822 822 821 821 822 822 821 844 842 1 877 459
586 820 824 822 458 877 841 842 458 820 821 821 458 820 761 147 458 876 843 842 491
