0a009f0c
20 27
467 435 419 276 244 245 435 468 435 467 435 276 277 276 276 468 435 467 468 276 244 245 276 33 437 468 276
467 419 435 212 212 212 467 419 419 419 435 212 212 212 212 468 419 419 468 212 212 212 212 435 33 469 276
419 467 467 276 276 276 468 435 467 435 467 213 213 245 276 468 435 467 435 245 276 276 276 467 468 33 276
213 212 276 244 473 276 276 212 213 213 212 244 213 277 276 245 276 212 276 276 276 473 276 244 213 213 213
245 212 276 276 505 216 276 212 276 213 212 276 277 276 244 213 435 467 435 467 276 505 216 276 213 213 213
277 212 276 276 537 276 245 212 213 213 435 467 435 467 276 213 467 468 467 468 276 537 276 276 276 277 276
435 467 435 435 276 213 213 212 213 213 467 468 467 468 212 212 467 468 468 435 244 276 499 500 500 501 502
467 468 467 467 276 276 276 212 213 277 467 468 468 435 276 276 468 435 468 435 244 245 534 912 913 911 534
435 467 435 467 276 276 435 467 435 276 276 212 276 245 276 244 213 213 212 244 245 499 566 944 624 946 563
467 468 467 468 212 276 467 468 467 276 276 212 212 213 245 276 213 213 212 276 276 534 723 688 687 689 721
468 468 468 435 212 245 467 468 468 276 276 276 212 276 277 276 212 212 212 276 473 563 502 720 721 721 499
468 435 468 467 212 277 276 245 213 213 435 467 435 467 276 276 212 276 277 276 505 780 534 720 721 721 534
244 245 276 244 245 276 276 277 213 213 467 468 467 468 276 276 212 276 276 277 537 181 473 720 721 721 473
213 277 213 277 473 276 276 276 276 276 468 468 468 435 276 468 468 467 276 276 276 276 505 452 454 453 505
213 213 213 276 505 216 276 212 276 276 468 435 468 435 245 468 33 469 212 212 212 276 537 212 212 212 537
213 213 277 276 537 276 276 212 245 276 276 276 212 213 213 435 435 468 276 276 212 276 276 276 212 212 276
468 467 468 468 276 276 276 212 277 245 276 276 212 213 213 277 212 244 245 435 435 467 435 276 212 212 276
468 419 468 435 276 467 467 468 276 277 276 467 467 435 468 276 212 276 277 419 467 468 467 276 212 212 276
467 435 419 468 212 467 419 435 212 212 212 467 419 419 435 212 212 212 212 435 467 435 435 212 212 212 276
468 467 468 467 276 467 468 435 276 276 276 467 468 468 435 276 276 276 276 467 468 467 419 276 276 276 276
