0a009f0c
20 27
467 435 419 276 244 245 435 468 435 467 435 276 277 276 276 468 435 467 468 276 244 245 276 1 437 468 276
467 419 435 470 436 471 467 419 419 419 435 438 436 438 436 468 419 419 468 470 436 438 436 435 1 469 276
419 467 467 276 276 276 468 435 467 435 467 213 213 245 276 468 435 467 435 245 276 276 276 467 468 1 276
213 438 276 244 473 276 276 439 213 213 439 244 213 277 276 245 276 470 276 276 276 473 276 244 213 213 213
245 436 276 276 505 216 276 436 276 213 436 276 277 276 244 213 435 467 435 467 276 505 216 276 213 213 213
277 471 276 276 537 276 245 438 213 213 435 467 435 467 276 213 467 468 467 468 276 537 276 276 276 277 276
435 467 435 435 276 213 213 436 213 213 467 468 467 468 470 436 467 468 468 435 244 276 499 500 500 501 502
467 468 467 467 276 276 276 471 213 277 467 468 468 435 276 276 468 435 468 435 244 245 534 912 913 911 534
435 467 435 467 436 439 435 467 435 276 276 470 276 245 276 244 213 213 439 244 245 499 566 944 624 946 563
467 468 467 468 212 276 467 468 467 276 276 436 439 213 245 276 213 213 436 276 276 534 723 688 687 689 721
468 468 468 435 212 245 467 468 468 276 276 276 436 276 277 276 438 436 439 276 473 563 502 720 721 721 499
468 435 468 467 212 277 276 436 213 213 435 467 435 467 276 276 436 276 277 276 505 780 534 720 721 721 534
244 245 276 244 245 276 276 439 213 213 467 468 467 468 276 276 471 276 276 277 537 181 473 720 721 721 473
213 277 213 277 473 276 276 436 470 436 468 468 468 435 276 468 468 467 276 276 276 276 505 452 454 453 505
213 213 213 276 505 216 276 439 276 276 468 435 468 435 245 468 1 469 438 436 439 276 537 436 438 436 537
213 213 277 276 537 276 276 436 245 276 276 276 438 213 213 435 435 468 276 276 436 276 276 276 436 471 276
468 467 468 468 276 276 276 471 277 245 276 276 470 213 213 277 436 244 245 435 435 467 435 276 439 436 276
468 419 468 435 276 467 467 468 276 277 276 467 467 435 468 276 470 276 277 419 467 468 467 276 436 470 276
467 435 419 468 470 467 419 435 438 436 439 467 419 419 435 438 436 438 436 435 467 435 435 436 470 436 276
468 467 468 467 276 467 468 435 276 276 276 467 468 468 435 276 276 276 276 467 468 467 419 276 276 276 276
