0a003a0c
28 22
426 720 426 427 427 883 883 885 427 426 427 426 427 521 820 821 822 821 822 821 822 821
722 721 722 722 722 915 916 917 723 722 722 722 722 459 431 902 521 820 821 933 902 521
721 721 721 656 595 596 624 949 595 657 721 721 721 459 463 419 459 820 822 459 419 459
721 719 720 688 627 688 660 689 627 689 721 719 720 491 430 787 553 820 821 552 787 553
721 751 859 721 721 688 687 689 721 721 721 751 859 458 773 483 773 820 822 773 483 773
484 720 721 484 901 427 426 427 426 484 720 721 721 484 806 451 805 820 821 805 451 805
679 452 453 679 614 609 805 608 609 679 452 454 453 679 823 825 824 821 822 825 824 825
743 452 453 743 823 824 825 824 825 743 452 454 453 743 820 822 821 822 821 822 821 822
824 825 824 825 822 821 822 821 822 825 824 825 824 825 822 821 822 821 822 821 822 821
821 822 821 822 821 822 821 822 821 822 821 822 821 822 821 822 821 822 821 822 821 822
822 933 901 426 426 426 521 820 822 821 822 821 933 901 426 426 426 426 426 521 820 821
821 490 723 786 786 722 459 820 821 719 719 820 459 723 722 722 722 722 722 459 820 822
822 721 785 1 1 784 459 820 822 813 813 858 459 720 721 721 721 721 721 459 820 821
821 459 720 786 786 721 459 820 821 822 821 822 459 720 721 721 721 721 721 459 820 822
822 552 426 426 720 426 553 820 822 719 719 820 552 484 720 484 432 720 721 459 820 821
821 824 825 824 822 824 825 822 821 813 813 858 608 742 483 742 495 720 721 459 820 822
822 821 822 821 822 821 822 821 822 821 822 821 824 826 824 826 459 720 721 459 820 821
426 426 426 426 426 426 426 426 521 820 821 822 821 822 821 822 459 720 721 552 426 426
897 897 897 897 897 897 897 898 459 820 822 719 820 719 820 821 459 720 721 722 722 722
929 929 929 929 929 929 929 930 459 820 821 813 858 813 858 822 459 720 721 721 721 721
3 36 35 8 3 4 3 3 554 820 822 821 822 821 822 821 459 720 721 721 721 721
162 583 433 426 426 426 426 426 553 820 821 719 820 719 820 822 552 426 484 720 721 484
41 554 723 786 722 825 824 825 824 821 822 813 858 813 858 821 608 609 742 452 453 742
43 586 784 1 784 933 901 426 521 820 821 822 821 822 821 822 825 824 826 824 825 826
162 554 720 786 721 459 899 900 459 820 822 821 822 821 822 821 822 821 822 821 822 821
99 583 433 426 426 583 931 932 583 433 426 426 583 820 821 822 821 822 583 430 426 426
100 615 896 897 898 615 2 3 615 896 897 898 615 452 454 454 454 453 615 896 897 898
41 711 928 929 930 711 34 72 713 928 929 930 743 452 454 454 454 453 743 928 929 930
