0a00290c
17 15
491 720 721 721 491 820 525 426 426 426 426 426 460 493 820
491 419 721 419 491 820 490 823 824 825 824 825 825 491 820
491 720 721 721 491 820 824 822 719 820 822 719 820 491 820
525 426 480 428 553 820 491 820 815 821 821 815 821 491 820
491 823 824 824 825 821 525 426 526 820 822 428 426 553 820
525 426 427 480 428 460 493 823 825 822 822 825 825 825 821
491 723 722 722 722 722 491 820 525 426 426 426 426 521 820
491 720 721 721 721 721 491 820 491 723 719 723 722 491 820
491 720 719 720 719 720 491 820 496 720 751 721 721 496 820
491 720 751 33 878 721 491 820 491 720 721 419 721 491 820
491 720 721 722 721 721 491 820 552 426 426 426 426 553 820
525 426 426 497 426 426 553 820 824 825 824 824 824 825 821
491 823 824 825 824 824 825 822 822 525 426 526 820 428 426
583 820 583 430 426 426 583 820 822 583 823 825 821 824 825
810 420 810 867 897 866 810 452 453 810 820 822 821 822 822
826 825 826 825 824 825 826 825 824 421 821 822 821 822 822
822 822 822 822 822 821 822 821 821 422 821 822 821 822 822
