0a00290c
10 15
825 824 824 825 822 822 525 426 526 820 428 426 460 461 426
430 426 426 583 820 822 583 823 825 821 824 825 824 491 867
867 897 866 810 452 453 810 820 822 821 822 822 822 491 631
825 824 825 826 825 824 421 821 822 821 822 822 822 491 662
822 822 821 822 821 821 422 821 822 821 822 822 822 491 662
426 426 426 426 426 426 583 430 426 583 417 418 583 465 662
739 866 739 866 739 866 810 867 739 810 452 453 810 867 694
269 198 273 275 203 195 710 268 269 710 761 760 710 761 726
337 305 724 337 201 272 262 724 724 724 724 724 756 724 724
301 194 230 337 724 724 724 724 726 724 724 724 724 337 231
