2c00c32e
29 30
500 501 501 500 501 500 501 500 501 499 500 501 500 501 566 184 212 244 245 212 212 244 213 213 213 245 212 212 212 244
722 722 722 722 722 722 722 722 722 534 582 148 512 148 512 184 244 213 213 245 244 213 473 213 473 213 245 212 244 213
721 721 721 721 721 721 721 721 721 534 151 180 181 180 181 244 213 213 213 213 213 213 505 213 505 213 213 213 213 213
721 721 721 721 721 721 721 721 721 534 184 212 245 212 244 213 213 213 213 213 213 213 537 213 537 213 213 213 213 213
721 721 721 721 721 721 721 721 721 534 184 276 213 213 473 213 213 213 435 467 438 436 438 436 438 436 435 468 213 213
565 484 720 721 721 484 565 565 565 566 184 212 213 213 505 213 213 213 467 435 436 470 436 470 436 470 467 468 213 213
148 773 452 454 453 773 148 512 148 512 184 244 213 213 537 213 438 435 435 467 438 436 438 436 438 436 435 468 213 213
180 181 486 454 453 151 180 181 180 181 244 213 213 213 213 213 436 467 467 435 436 470 436 470 436 470 467 468 213 213
212 244 435 467 468 245 212 244 438 436 438 436 438 436 438 436 438 435 435 467 438 436 438 436 438 436 435 468 213 213
473 213 467 467 435 213 473 213 436 470 436 470 436 470 436 470 436 467 467 435 436 470 436 470 436 470 435 468 213 213
505 215 435 467 467 213 505 215 438 436 499 500 886 887 886 500 502 437 467 468 213 213 213 213 213 213 467 468 213 213
537 213 435 468 468 213 537 213 436 470 531 722 915 916 917 723 534 469 435 468 213 213 213 473 213 213 435 468 213 213
213 213 467 468 435 213 213 213 438 436 531 721 596 624 949 721 534 437 435 468 213 213 213 505 215 213 435 468 213 213
213 213 435 467 468 213 213 213 436 470 531 721 688 627 689 721 534 469 435 467 213 213 213 537 213 213 435 467 213 213
213 213 467 467 435 213 213 213 438 436 531 484 720 721 721 484 534 437 435 435 213 213 213 213 468 435 435 435 213 213
213 213 435 467 467 213 213 213 436 470 563 503 452 454 453 503 566 440 436 213 213 213 213 213 435 467 468 468 213 213
473 213 467 468 467 213 473 213 438 436 504 535 438 436 470 535 504 436 438 213 213 213 213 213 467 435 468 468 213 213
505 215 435 468 468 213 505 215 436 470 436 470 436 470 436 438 436 471 436 213 213 213 213 213 467 468 435 468 213 213
537 213 467 468 435 213 537 213 213 213 213 213 467 435 468 435 468 213 213 213 213 213 213 213 438 436 438 436 213 213
213 213 435 467 468 213 213 213 213 473 213 213 435 435 467 435 467 213 213 473 213 213 213 213 436 470 436 470 213 213
213 213 467 467 435 213 213 213 213 505 215 213 468 435 467 468 435 213 213 505 215 213 213 213 438 436 438 436 213 213
213 213 435 467 467 213 213 213 213 537 213 213 467 435 435 467 435 213 213 537 213 213 213 213 436 471 436 471 213 213
213 213 438 436 438 467 468 467 468 467 468 435 438 436 438 436 439 467 468 435 467 468 439 436 439 436 439 436 213 213
473 213 438 436 438 467 468 435 468 467 468 467 438 436 438 436 470 467 468 435 468 468 438 436 438 436 438 436 213 213
505 215 436 471 436 435 467 468 467 435 467 468 436 471 436 471 436 435 467 468 435 468 436 470 436 470 436 470 213 213
537 213 439 436 439 467 467 435 435 467 467 435 439 436 439 436 439 467 468 435 435 467 438 436 438 436 438 436 213 213
213 213 436 470 436 435 467 467 467 468 435 435 436 470 436 470 436 435 435 467 468 435 436 470 436 470 436 470 213 213
213 213 213 213 213 213 213 213 213 213 213 213 213 213 213 213 213 213 213 213 213 213 213 213 213 213 213 213 213 213
213 213 213 213 213 213 213 213 213 213 213 213 213 213 213 213 213 213 213 213 213 213 213 213 213 213 213 213 213 213
