7300cd75
32 32
870 836 837 804 841 870 805 841 839 804 841 870 805 841 568 55 2 55 668 841 870 805 841 839 804 841 870 805 841 839 804 805
839 806 804 805 873 870 837 873 870 836 873 839 837 873 665 55 34 55 700 873 839 837 873 870 836 873 870 837 873 870 836 837
839 804 806 837 841 839 804 974 839 806 841 839 804 841 152 56 636 57 55 841 839 804 841 839 806 974 839 804 841 839 806 804
839 838 805 806 873 870 805 873 839 804 873 870 805 873 184 573 538 574 121 873 870 805 873 839 804 841 870 805 873 839 804 805
870 836 837 804 841 870 837 841 870 836 841 839 837 841 152 573 538 574 55 841 839 837 973 870 836 873 870 837 841 870 836 837
839 806 804 805 841 839 804 873 839 806 873 839 804 873 119 573 538 574 151 873 839 804 873 839 806 841 839 804 873 839 806 804
839 804 806 837 841 870 805 841 839 804 973 870 805 873 813 635 604 603 813 873 870 805 841 839 804 873 870 805 973 839 804 805
839 838 805 806 873 870 837 873 870 836 873 839 837 873 846 309 311 310 845 873 839 837 873 870 836 841 870 837 873 870 836 837
870 836 837 804 841 839 804 905 876 874 908 839 804 841 878 281 281 281 879 841 839 806 841 839 806 905 876 874 908 839 806 804
839 806 804 805 973 870 805 873 966 933 873 870 805 873 319 249 249 249 317 873 839 804 873 839 804 841 966 932 873 839 804 805
839 804 806 837 873 870 837 841 902 901 841 870 837 841 319 249 249 249 317 974 870 836 841 870 836 873 902 900 841 870 836 837
839 838 805 806 873 839 804 873 839 806 873 839 804 973 319 249 249 249 317 873 839 806 873 839 806 973 839 804 873 839 806 804
870 836 837 804 905 876 874 908 839 804 841 870 805 841 319 249 249 249 317 905 876 874 908 839 804 841 870 805 841 839 804 805
839 806 804 805 841 966 932 873 870 836 873 870 837 873 319 249 249 249 317 841 966 932 873 870 836 873 870 837 873 870 836 837
839 804 806 837 873 902 901 841 839 806 841 839 804 841 351 313 313 313 284 841 902 900 841 839 806 841 839 804 841 839 806 804
839 838 805 806 974 870 805 873 839 804 873 839 805 813 844 875 876 910 810 813 839 804 974 839 804 873 870 805 873 839 804 805
870 836 837 804 841 870 837 841 870 836 841 870 837 845 966 841 966 941 933 845 870 836 841 870 836 841 870 837 841 870 836 837
839 806 804 805 873 839 804 873 839 806 973 839 804 877 901 873 902 901 900 877 871 806 905 876 874 908 839 804 974 839 806 804
839 804 806 837 841 839 805 841 870 804 841 870 805 836 837 841 839 837 804 836 837 804 841 966 932 873 870 805 841 839 804 805
839 838 805 806 873 870 837 974 870 836 813 843 909 809 810 813 843 809 810 809 910 810 813 902 900 873 870 837 873 870 836 837
809 810 909 874 908 839 804 841 839 806 845 966 941 932 933 845 966 932 933 932 942 933 845 870 836 973 839 838 841 839 806 804
966 932 942 933 841 870 805 873 839 804 877 900 901 900 900 877 900 900 901 900 900 901 877 871 804 905 876 874 908 839 804 805
902 901 901 900 841 870 837 841 870 836 804 805 806 804 805 806 804 805 806 804 805 806 804 804 806 841 966 933 841 870 836 837
870 836 837 804 873 839 804 905 876 910 809 810 809 874 875 876 909 810 809 810 874 875 876 910 810 813 902 900 873 839 806 804
839 806 804 805 841 839 805 873 966 942 933 932 933 932 841 966 941 932 932 933 932 841 966 941 932 845 839 836 841 839 804 805
839 804 806 837 973 870 837 841 902 900 901 901 901 900 841 902 900 901 900 901 900 873 902 900 901 877 871 805 973 870 836 837
839 838 805 806 841 839 804 873 870 836 806 836 806 837 873 870 836 806 836 806 837 873 870 836 806 836 804 806 873 839 806 804
870 836 837 804 813 843 810 813 843 809 810 809 909 809 813 843 810 809 810 910 810 813 843 809 909 874 875 876 813 839 804 805
839 806 804 805 845 966 933 845 966 932 933 932 941 932 845 966 933 932 933 942 933 845 966 932 941 932 841 966 845 870 836 837
839 838 806 837 877 900 901 877 900 901 900 900 901 900 877 901 900 900 901 900 900 877 900 900 901 900 873 902 877 871 837 838
839 804 805 806 804 805 806 804 805 806 804 805 806 804 805 806 804 805 806 804 805 806 804 805 806 837 973 870 804 805 806 804
870 836 837 804 836 837 804 836 837 804 836 837 804 836 837 804 836 837 804 836 837 804 836 837 804 836 841 839 806 837 804 836
